Version 16 of Simpler AIF by Another Wannabe begins here.

"An AIF authoring extension that includes the very basics of writing interactive sex scenes."

Part - Stage Rules

Chapter - Redirect Rules

The redirect rules are an action based rulebook. The redirect rules have default success.

This is the redirect phase rule:
	anonymously abide by the redirect rules.

The redirect phase rule is listed before the before stage rule in the action-processing rules.


Chapter - Modified Check Rule

[This is the modified check stage rule:
	anonymously follow the specific check rulebook.
		
The modified check stage rule is listed instead of the check stage rule in the specific action-processing rules.]

Chapter - Modified After Stage Rule

This is the simpler aif after stage rule:
	if action in world is true:
		follow the after rules;
		if rule succeeded or rule failed:
			follow the post-action bookkeeping rules;
			rule succeeds.
The simpler aif after stage rule is listed instead of the after stage rule in the specific action-processing rulebook.

Part - Body parts by Dudeman

 A thing can be orificial, penile, sexually interactive or sexually non-interactive (this is its interactivity descriptor). A thing is usually sexually non-interactive.

A body part is a kind of thing. [A body part can be sexable. A body part is usually sexable. ] A body part is usually sexually interactive.

Definition: A thing is sexable if it is not sexually non-interactive.
Definition: A thing is fuckable if it is orificial or it is penile.

Definition: A person (called the bwner) is a NPC if the bwner is not the player and the bwner is not an animal.

Some breasts are a kind of body part. They are orificial. The plural of breasts is pairs of breasts. Some breasts is part of every woman.
Understand "tit/tits/breast/breasts/boob/boobs/tittie/titties/nipple/nipples" as breasts. 
your breasts are breasts.

An ass is a kind of body part. They are orificial. The plural of ass is asses. An ass is part of every woman. ass is a part of every man.
Understand "ass/asshole/anus/rear/backside/butt/keister/bottom/fanny/rump" and "rear end" as ass. 
your ass is an ass.

A pussy is a kind of body part. It is orificial. A pussy is part of every woman.
Understand "vagina/cunt/slit/crotch/snatch/clitoris/clit/twat/sex" as pussy. 
your pussy is a pussy.

A cock is a kind of body part. It is penile. A cock is a part of every man. 
Understand "cock/penis/dick/wang/dong/wiener/willy/schlong/boner/pecker" as cock. 
your cock is a cock.

The bodily construction rules are a rulebook.

A bodily construction rule (this is the default bodily construction rule):
	now your ass is part of the player;
	if the player is male:
		now your cock is part of the player;
	else if the player is female:
		now your breasts are part of the player;
		now your pussy is part of the player.

When play begins (this is the construct the player's body rule):
	if the player is yourself:
		follow the bodily construction rules.


Understand "yourself" as a person when the item described is the person asked.

Understand "your" as a thing when the item described is enclosed by the person asked.
Understand "my" as a thing when the item described is enclosed by the player.

Section - Optional Body Parts

Some hair is a kind of body part. The plural of hair is heads of hair. It is sexually non-interactive. It is ambiguously plural. [Some hair is a part of every man. Some hair is a part of every woman.] Understand "hair/hairdo/haircut/hairstyle/scalp/baldness" as hair.
your hair is hair.

A face is a kind of body part. A face is orificial. [A face is a part of every man. A face is part of every woman.] Understand "head/nose/cheeks/cheek/face/brow/forehead/mouth/lips" as a face.
your face is a face.

Some eyes are a kind of body part. It is sexually non-interactive. They are plural-named. The plural of eyes is pairs of eyes. [Some eyes are a part of every man. Some eyes are a part of every woman.] Understand "eyes/eye/pupils/pupil/iris/irises" and "eye brow/brows" as eyes.
your eyes are some eyes.

Some arms are a kind of body part. The plural of arms is pairs of arms. It is sexually non-interactive. They are plural-named. [Some arms are a part of every man. Some arms are a part of every woman.] Understand "arms/arm/hands/hand/finger/fingers" and "eye brow/brows" as arms.
your arms are some arms.

Some legs are a kind of body part. The plural of legs is pairs of legs. They are plural-named. [Some legs are a part of every man. Some legs are a part of every woman.] Understand "leg/legs/thigh/thighs" as legs.
your legs are some legs.

A tummy is a kind of body part. The plural of tummy is tummies. Understand "tummy/stomach/abs/abdominals/abdomen" as the tummy.
your tummy is a tummy.

A chest is a kind of body part. Understand "chest/pecs/pectorals" as the chest.
your chest is a chest.

Some feet are a kind of body part. They are sexually non-interactive. The plural of feet is pairs of feet. They are plural-named. Understand "feet/foot/toes/toe" as feet.
your feet are some feet.

Some hands are a kind of body part. They are sexually non-interactive. The plural of hands is pairs of hands. They are plural-named. Understand "hand/hands/finger/fingers/palm/palms" as hands.
your hands are some hands.

Chapter - Phrases to Choose Body Parts

To decide which object is the/-- breasts of (the individual - a person):
	if the individual incorporates breasts (called the item):
		decide on the item;
	decide on nothing.
To decide which object is the/-- ass of (the individual - a person):
	if the individual incorporates an ass (called the item):
		decide on the item;
	decide on nothing.
To decide which object is the/-- cock of (the individual - a person):
	if the individual incorporates a cock (called the item):
		decide on the item;
	decide on nothing.
To decide which object is the/-- pussy of (the individual - a person):
	if the individual incorporates a pussy (called the item):
		decide on the item;
	decide on nothing.
To decide which object is the/-- hair of (the individual - a person):
	if the individual incorporates some hair (called the item):
		decide on the item;
	decide on nothing.
To decide which object is the/-- face of (the individual - a person):
	if the individual incorporates a face (called the item):
		decide on the item;
	decide on nothing.
To decide which object is the/-- eyes of (the individual - a person):
	if the individual incorporates some eyes (called the item):
		decide on the item;
	decide on nothing.
To decide which object is the/-- arms of (the individual - a person):
	if the individual incorporates some arms (called the item):
		decide on the item;
	decide on nothing.
To decide which object is the/-- legs of (the individual - a person):
	if the individual incorporates some legs (called the item):
		decide on the item;
	decide on nothing.
To decide which object is the/-- tummy of (the individual - a person):
	if the individual incorporates a tummy (called the item):
		decide on the item;
	decide on nothing.
To decide which object is the/-- chest of (the individual - a person):
	if the individual incorporates a chest (called the item):
		decide on the item;
	decide on nothing.
To decide which object is the/-- feet of (the individual - a person):
	if the individual incorporates some feet (called the item):
		decide on the item;
	decide on nothing.
To decide which object is the/-- hands of (the individual - a person):
	if the individual incorporates some hands (called the item):
		decide on the item;
	decide on nothing.


[To decide which object is the fuck organ of (X - a person):
	if the cock of X is not nothing:
		decide on the cock of X;
	if the pussy of X is not nothing:
		decide on the pussy of X;
	decide on nothing.
To decide which object is the fucked organ of (X - a person):
	if the pussy of X is not nothing:
		decide on the pussy of X;
	if the ass of X is not nothing:
		decide on the ass of X;
	decide on nothing.]

To switch gender:
	repeat with X running through body parts incorporated by the player:
		now X is off-stage;
	if the player is male:
		now the player is female;
	else if the player is female:
		now the player is male;
	if the player is heterosexual:
		now the player is homosexual;
	else if the player is homosexual:
		now the player is heterosexual;
	follow the bodily construction rules.

Part - Sex Commands by Dudeman

A person can be sexable. A woman is usually sexable. A man is usually sexable. An animal is usually not sexable.


Chapter - The Sex Partner

To decide which object is the sex partner:
	if the noun is a person:
		decide on the noun;
	else if the noun is enclosed by a person (called the partner):
		decide on the partner;
	else:
		decide on nothing.

Chapter - Message System

The reported reason is a rule that varies.

The issue failure message rules is a rulebook. The issue failure message rules have default success.

To issue failure message for (x - a rule):
	now the reported reason is x;
	follow the issue failure message rules.

Last issue failure message rule (this is the issue message of failure for given action rule):
	if the reported reason is a rule name listed in the Table of Failure Responses:
		say "[message entry][paragraph break]";
	else:
		continue the action.


Chapter - Kissing

Understand "kiss [something]" and "smooch [something]" and "make out with [something]" and "french [something]" and "peck [something]" as kissing.

To kiss is a verb.

Redirect an actor kissing a body part (this is the redirect kissing a body part to licking the body part rule): try the actor licking the noun.
[the redirect kissing a body part to licking the body part rule is listed first in the check kissing rulebook.]

Check an actor kissing something (this is the can't kiss anything but people rule):
	if the noun is not a person:
		issue failure message for the can't kiss anything but people rule;
		rule succeeds.
[		if the actor is the player:
			say "[We] [can't kiss] [the noun]." (A) instead;
		else:
			rule fails.]
		
Check an actor kissing someone (this is the can't kiss one's self rule):
	if the noun is the actor: 
		issue failure message for the can't kiss one's self rule;
		rule succeeds.
[		if the actor is the player:
			say "[We] [can't kiss] [themselves]." (A) instead;
		else:
			rule fails.]

The block kissing rule is not listed in any rulebook.

Report an actor kissing something (this is the standard kissing rule): say "[The actor] [kiss] [the noun]." (A).

[Persuasion rule for asking people to try kissing (this is the convince people to kiss rule): persuasion succeeds. ]
Last unsuccessful attempt by someone kissing (this is the suppress messages for failing to kiss rule): stop the action.

[Unsuccessful attempt by someone kissing when the reason the action failed is the can't kiss anything but people rule (this is the kissfail1 rule):
	say "[The actor] [can't kiss] [the noun]." (A).
Unsuccessful attempt by someone kissing when the reason the action failed is the can't kiss one's self rule (this is the kissfail2 rule):
	say "[The actor] [can't kiss] [themselves]." (A).]

[Last unsuccessful attempt by someone kissing (this is the display messages for failing to kiss rule):
	if the reason the action failed is a rule name listed in the table of npc failure responses:
		say "[message entry][paragraph break]";
	else:
		rule succeeds.]
	
Table of Failure Responses
rule name	message
the can't kiss anything but people rule	"[The person asked] [can't kiss] [the noun]."
the can't kiss one's self rule	"[The person asked] [can't kiss] [themselves]."


Chapter - Rubbing

[Persuasion rule for asking someone to try rubbing: persuasion succeeds.]

Understand the command "scrub" as something new.
Understand the command "touch" as something new.

Understand "grope [something]" and "fondle [something]" and "massage [something]" and "touch [something]" and "pet [something]" or "play with [something]" or "feel up [something]" as rubbing.

Redirect an actor touching something sexable (this is the redirect touching to rubbing rule): try the actor rubbing the noun.

Redirect an actor rubbing a person enclosing a cock (called the dick) (this is the redirect rubbing a person to rubbing their cock rule): try the actor rubbing the dick.

Redirect an actor rubbing a person enclosing a pussy (called the cunt) (this is the redirect rubbing a person to rubbing their pussy rule): try the actor rubbing the cunt.

Redirect an actor rubbing something that is not sexable (this is the redirect rubbing a unsexable thing to touching rule): try the actor touching the noun.

Last unsuccessful attempt by someone rubbing (this is the suppress messages for failing to rub rule): stop the action.


Chapter - Licking/sucking

Understand the command "blow" as something new.

[Persuasion rule for asking a person to try licking: persuasion succeeds.]

Understand "lick [something]" or "tongue [something]" or "suck [something]" or "eat out [something]" or "blow [something]" or "go down on [something]" as licking. Licking is an action applying to one thing.

To lick is a verb.
To suck is a verb.

Redirect an actor licking a person enclosing a cock (called the dick) (this is the redirect licking a person to licking their cock rule): try the actor licking the dick.

Redirect an actor licking a person enclosing a pussy (called the cunt) (this is the redirect licking a person to licking their pussy rule): try the actor licking the cunt.

Redirect an actor licking a face that is not enclosed by the actor (this is the redirect licking a face to kissing rule):
	try the actor kissing the holder of the noun.

Check an actor licking a pussy (this is the can't lick one's own pussy rule):
	if the actor is the sex partner:
		issue failure message for the can't lick one's own pussy rule;
		rule succeeds.

The can't lick one's own pussy rule is listed first in the check licking rules.

Check an actor licking an ass (this is the can't lick one's own ass rule):
	if the actor is the sex partner:
		issue failure message for the can't lick one's own ass rule;
		rule succeeds.

The can't lick one's own ass rule is listed first in the check licking rules.

Check an actor licking a cock (this is the can't lick one's own cock rule):
	if the actor is the sex partner:
		issue failure message for the can't lick one's own cock rule;
		rule succeeds.

Check an actor licking a face (this is the can't lick one's own face rule):
	if the actor is the sex partner:
		issue failure message for the can't lick one's own face rule;
		rule succeeds.

Check an actor licking some legs (this is the can't lick one's own legs rule):
	if the actor is the sex partner:
		issue failure message for the can't lick one's own legs rule;
		rule succeeds.
		
Check an actor licking a tummy (this is the can't lick one's own tummy rule):
	if the actor is the sex partner:
		issue failure message for the can't lick one's own tummy rule;
		rule succeeds.

Check an actor licking a chest (this is the can't lick one's own chest rule):
	if the actor is the sex partner:
		issue failure message for the can't lick one's own chest rule;
		rule succeeds.

Check an actor licking something not sexable (this is the can't lick just anything rule):
	issue failure message for the can't lick just anything rule;
	rule succeeds.

The can't lick one's own cock rule is listed first in the check licking rules.

Last unsuccessful attempt by someone licking (this is the suppress messages for failing to lick rule): stop the action.

[Last unsuccessful attempt by someone licking (this is the display messages for failing to lick rule):
	if the reason the action failed is a rule name listed in the table of npc failure responses:
		say "[message entry][paragraph break]";
	else:
		rule succeeds.]

Table of Failure Responses (continued)
rule name	message
the can't lick one's own pussy rule	"[The person asked] [can't lick] [their] own pussy."
the can't lick one's own ass rule	"[The person asked] [can't lick] [their] own ass."
the can't lick one's own cock rule	"[The person asked] [can't lick] [their] own cock."
the can't lick one's own face rule	"[The person asked] [can't lick] [their] own face."
the can't lick one's own legs rule	"[The person asked] [can't lick] [their] own legs."
the can't lick one's own tummy rule 	"[The person asked] [can't lick] [their] own tummy."
the can't lick one's own chest rule	"[The person asked] [can't lick] [their] own chest."
the can't lick just anything rule	"[The person asked] [shouldn't lick] [the noun]."

Report an actor licking something (this is the standard report licking rule): say "[The actor] [lick] [the noun]." (A).


Chapter - Masturbating

Masturbating is an action applying to nothing. Understand "masturbate" or "jackoff" or "jack off" as masturbating.

To masturbate is a verb.

Redirect an actor masturbating (this is the can't masturbate without genitals rule):
	if the actor encloses a cock (called the item):
		try the actor rubbing the item;
	else if the actor encloses a pussy (called the item2):
		try the actor rubbing the item2;
	else:
		say "[The actor] [have] no obvious genitalia to masturbate with." (A).
		
[Persuasion rule for asking people to try masturbating: persuasion succeeds. ]

Chapter - Fucking

Understand the command "fuck" as something new. Understand "fuck [something]", "screw [something]", "bone [something]", "bang [something]", "hump [something]", "boff [something]", "make love to [something]", "have sex with [something]", or "penetrate [something]" as fucking. Fucking is an action applying to one thing.

To fuck is a verb.

Use no face-fucking translates as (- Constant NO_FACE_FUCKING; -).

Redirect an actor fucking a male person (this is the redirect attempts to fuck a male person rule):
	let the likely part be an object;
	let the likely instrument be an object;
	if the actor is female:
		now the likely part is the object produced by the default penile organ rules for the noun;
		now the likely instrument is the object produced by the default orificial organ rules for the actor;
	else if the actor is male:
		now the likely part is the object produced by the default orificial organ rules for the noun;
		now the likely instrument is the object produced by the default penile organ rules for the actor;
	if the likely part is nothing:
		say "[The noun] [have] nothing obvious to fuck!" (A);
	else if the likely instrument is nothing:
		say "[The actor] [have] nothing obvious to fuck with!" (B);
	else:
		try the actor fucking the likely part with the likely instrument.

Redirect an actor fucking a female person (this is the redirect attempts to fuck a female person rule):
	let the likely part be an object;
	let the likely instrument be an object;
	now the likely part is the object produced by the default orificial organ rules for the noun;
	now the likely instrument is the object produced by the default penile organ rules for the actor;
	if the likely part is nothing:
		say "[The noun] [have] nothing obvious to fuck!" (A);
	else if the likely instrument is nothing:
		say "[The actor] [have] nothing obvious to fuck with!" (B);
	else:
		try the actor fucking the likely part with the likely instrument.

Redirect an actor fucking something orificial (this is the redirect attempts to fuck something orificial rule):
	let the likely instrument be an object;
	now the likely instrument is the object produced by the default penile organ rules for the actor;
	if the likely instrument is nothing:
		say "[The actor] [have] nothing obvious to fuck with!" (A);
	else:
		try the actor fucking the noun with the likely instrument.

Redirect an actor fucking something penile (this is the redirect attempts to fuck something penile rule):
	let the likely instrument be an object;
	now the likely instrument is the object produced by the default orificial organ rules for the actor;
	if the likely instrument is nothing:
		say "[The actor] [have] nothing obvious to fuck with!" (A);
	else:
		try the actor fucking the noun with the likely instrument.

Check an actor fucking something (this is the block attempts to fuck rule):
	issue failure message for the block attempts to fuck rule;
	rule succeeds.

Report an actor fucking something (this is the standard report fucking rule): say "[The actor] [fuck] [the noun].".

[Last unsuccessful attempt by someone fucking (this is the display messages for failing to fuck rule):
	if the reason the action failed is a rule name listed in the table of npc failure responses:
		say "[message entry][paragraph break]";
	else:
		rule succeeds.]

Table of Failure Responses (continued)
rule name	message
the block attempts to fuck rule	"[The person asked] [shouldn't fuck] [the noun]."	

Section - Mouthfucking

Mouthfucking is an action applying to one thing. Understand "mouthfuck [someone]" and "facefuck [someone]" as mouthfucking.

Persuasion rule for asking people to try mouthfucking (this is the permit asking to mouthfuck rule): persuasion succeeds. 
Unsuccessful attempt by someone mouthfucking: stop the action.

Redirect an actor mouthfucking a person (called the individual) (this is the redirect mouthfucking rule):
	let the likely instrument be the object produced by the default penile organ rules for the actor;
	if the likely instrument is nothing:
		say "[The actor] [have] nothing obvious to fuck with." (A);
	else if the individual encloses a face (called the butt):
		try the actor fucking the butt with the likely instrument;
	else:
		try the individual licking the likely instrument.


Section - Titfucking

Persuasion rule for asking people to try titfucking (this is the permit asking to titfuck rule): persuasion succeeds. 
Unsuccessful attempt by someone titfucking: stop the action.

Understand "titfuck [someone]" as titfucking. Titfucking is an action applying to one thing.

Redirect an actor titfucking a person (called the individual) (this is the redirect titfucking rule):
	let the likely instrument be the object produced by the default penile organ rules for the actor;
	if the likely instrument is nothing:
		say "[The actor] [have] nothing obvious to fuck with." (A);
	else if the individual encloses breasts (called the butt):
		try the actor fucking the butt with the likely instrument;
	else:
		say "[The individual] [have] no breasts to fuck." (B).


Section - Assfucking

Understand "assfuck [someone]" or "buttfuck [someone]" or "cornhole [someone]" as assfucking. Assfucking is an action applying to one thing.

Persuasion rule for asking people to try assfucking (this is the permit asking to assfuck rule): persuasion succeeds.
Unsuccessful attempt by someone titfucking: stop the action.

Redirect an actor assfucking a person (called the individual) (this is the redirect assfucking rule):
	let the likely instrument be the object produced by the default penile organ rules for the actor;
	if the likely instrument is nothing:
		say "[The actor] [have] nothing obvious to fuck with." (A);
	else if the individual encloses an ass (called the butt):
		try the actor fucking the butt with the likely instrument;
	else:
		say "[The individual] [have] no ass to fuck." (B).
		
Section - Frotting/Tribbing

Frotting is an action applying to one thing. Understand "frot [someone]" and "trib [someone]" as frotting. 

Persuasion rule for asking people to try frotting (this is the permit asking to frot rule): persuasion succeeds.
Unsuccessful attempt by someone frotting: stop the action.

Redirect an actor frotting a person (called the individual) (this is the redirect frotting rule):
	if the actor encloses a cock (called X) and the individual encloses a cock (called Y):
		try the actor fucking Y with X;
	else if the actor encloses a pussy (called X) and the individual encloses a pussy (called Y):
		try the actor fucking Y with X;
	else:
		try the actor fucking the noun.

Chapter - Sex Toys and Fucking it with

Section - Sex Toys

A sex toy is a kind of thing. A sex toy is usually penile.

A strap-on is a kind of sex toy. A strap-on is wearable.

A vibrator is a kind of sex toy. A vibrator can be switched on or switched off. A vibrator is usually switched off.

A vibrating strap-on is a kind of sex toy. A vibrating strap-on can be switched on or switched off. A vibrating strap-on is usually switched off. 

Check an actor wearing a strap-on (this is the prevent a person with a cock from wearing a strap-on rule):
	if the actor encloses a cock:
		issue failure message for the prevent a person with a cock from wearing a strap-on rule;
		rule succeeds.

Check an actor wearing a strap-on (this is the can't wear two strap-ons rule):
	if the actor wears a strap-on:
		issue failure message for the can't wear two strap-ons rule;
		rule succeeds.

		
Persuasion rule for asking a person to try wearing a strap-on (this is the allow NPCs to wear strap-ons rule):
	if the person asked is sex ready:
		persuasion succeeds;
	else:
		say "[Generic sex refusal message of the person asked]" (A);
		persuasion fails.
Persuasion rule for asking a person to try taking off a strap-on (this is the allow NPCs to take off strap-ons rule):
	if the person asked is sex ready:
		persuasion succeeds;
	else:
		say "[Generic sex refusal message of the person asked]" (A);
		persuasion fails.
Persuasion rule for asking a person to try taking a sex toy (this is the allow NPCs to take sex toys rule):
	if the person asked is sex ready:
		persuasion succeeds;
	else:
		say "[Generic sex refusal message of the person asked]" (A);
		persuasion fails.
Persuasion rule for asking a person to try dropping a sex toy (this is the allow NPCs to drop sex toys rule):
	if the person asked is sex ready:
		persuasion succeeds;
	else:
		say "[Generic sex refusal message of the person asked]" (A);
		persuasion fails.

Unsuccessful attempt by someone wearing a strap-on (this is the suppress message for failing to wear a strap-on rule):
	stop the action.

Table of Failure Responses (continued)
rule name	message
the prevent a person with a cock from wearing a strap-on rule	"[The person asked] [can't wear] [a noun] over [their] cock."
the can't wear two strap-ons rule	"[The person asked] [can wear] only one strap-on at a time."

Section - Default Fucktools

The last fucktool is an object that varies. The last fucktool is nothing.

Post-action bookkeeping for fucking something with something (this is the define the last fucktool rule):
	now the last fucktool is the second noun.

The default penile organ rules are a person based rulebook producing an object.

A default penile organ rule for a person (called the individual) (this is the default to the last penile fucktool rule):
	if the individual encloses the last fucktool and the last fucktool is penile:
		rule succeeds with result last fucktool.

A default penile organ rule for a person (called the individual) (this is the default to a penis rule):
	if the individual encloses a cock (called the dick):
		rule succeeds with result dick.

A default penile organ rule for a person (called the individual) (this is the default to other penile organs rule):
	if the individual encloses a penile body part (called the dick):
		rule succeeds with result dick.

A default penile organ rule for a person (called the individual) (this is the default to penile sex toys rule):
	if the individual encloses a penile sex toy (called the dick):
		rule succeeds with result dick.

Last default penile organ rule for a person (called the individual) (this is the fail defaulting a penile organ rule):
	if the individual encloses a cock (called the item):
		rule succeeds with result item;
	if the individual encloses a pussy (called the item):
		rule succeeds with result item;
	rule succeeds with result nothing.

The default orificial organ rules are a person based rulebook producing an object.

A default orificial organ rule for a person (called the individual) (this is the default to the last orificial fucktool rule):
	if the individual encloses the last fucktool and the last fucktool is orificial:
		rule succeeds with result last fucktool.

A default orificial organ rule for a person (called the individual) (this is the default to a vagina or ass rule):
	if the individual encloses a pussy (called the item):
		rule succeeds with result item;
	if the individual encloses an ass (called the item):
		rule succeeds with result item.

A default orificial organ rule for a person (called the individual) (this is the default to other orificial organs rule):
	if the individual encloses a orificial body part (called the item):
		rule succeeds with result item.

A default orificial organ rule for a person (called the individual) (this is the default to orificial sex toys rule):
	if the individual encloses a orificial sex toy (called the item):
		rule succeeds with result item.

Last default orificial organ rule for a person (called the individual) (this is the fail defaulting a orificial organ rule):
	if the individual encloses a pussy (called the item):
		rule succeeds with result item;
	if the individual encloses a cock (called the item):
		rule succeeds with result item;
	rule succeeds with result nothing.

Section - The Fucking It With Action

Fucking it with is an action applying to two things. Understand "fuck [something] with/using [something]" and "screw [something] with/using [something]" and "penetrate [something] with/using [something]" as fucking it with. [Understand "use [something] on [something]" as fucking it with (with nouns reversed).]

To use is a verb.

Redirect an actor fucking a person with something (this is the redirect attempts to fuck a person with something to fucking a body part rule):
	let the likely part be an object;
	if the second noun is orificial or the second noun is penile:
		if the second noun is penile:
			now the likely part is the object produced by the default orificial organ rules for the noun;
		else if the second noun is orificial:
			now the likely part is the object produced by the default penile organ rules for the noun;
	else if the noun is male:
		now the likely part is the object produced by the default penile organ rules for the noun;
	else if the noun is female:
		now the likely part is the object produced by the default orificial organ rules for the noun;
	if the likely part is nothing:
		say "[The noun] [have] nothing obvious to fuck!" (A);
	else:
		try the actor fucking the likely part with the second noun.

Redirect an actor fucking something with a person (this is the redirect attempts to fuck something with a person to fucking with a body part rule):
	let the likely part be an object;
	if the noun is orificial or the noun is penile:
		if the noun is penile:
			now the likely part is the object produced by the default orificial organ rules for the second noun;
		else if the noun is orificial:
			now the likely part is the object produced by the default penile organ rules for the second noun;
	else if the second noun is male:
		now the likely part is the object produced by the default penile organ rules for the second noun;
	else if the second noun is female:
		now the likely part is the object produced by the default orificial organ rules for the second noun;
	if the likely part is nothing:
		say "[The noun] [have] nothing obvious to fuck!" (A);
	else:
		try the actor fucking noun with the likely part.

Redirect an actor fucking something enclosed by the actor with something enclosed by a person who is not the actor (this is the redirect attempts to fuck the actor with someone else's body part to the other person fucking the actor rule):
	if the second noun is enclosed by a person (called the individual):
		try the individual fucking the noun with the second noun.

Redirect an actor fucking a face with a face (this is the redirect attempts to fuck a face with a face to kissing rule):
	if the noun is enclosed by a person (called the individual):
		try the actor kissing the individual;
	else:
		continue the action.

Redirect an actor fucking something with a face enclosed by the actor (this is the redirect attempts to fuck with a face to licking rule):
	try the actor licking the noun instead.
	
Redirect an actor fucking a sex toy with a body part (this is the redirect attempts to fuck a sex toy with a body part to fucking a body part rule):
	if the second noun is enclosed by a person (called the individual):
		try the individual fucking the second noun with the noun;
	else:
		continue the action.

Redirect an actor fucking a face with something when the no face-fucking option is active (this is the disable face-fucking rule):
	if the noun is enclosed by a person (called the individual):
		try the individual licking the second noun;
	else:
		continue the action.

Redirect an actor fucking something with a face (this is the no fucking with a face rule):
	if the second noun is enclosed by the actor:
		try the actor licking the noun;
	else:
		continue the action.
		
Redirect an actor fucking something with some hands (this is the no fucking with hands rule):
	if the second noun is enclosed by the actor:
		try the actor rubbing the noun;
	else:
		continue the action.	

Redirect an actor fucking a person with something penile (this is the redirect fucking a person with something penile to fucking a body part rule):
	let the likely organ be the object produced by the default orificial organ rules for the noun;
	if the likely organ is nothing:
		say "[The noun] [have] nothing obvious to fuck." (A);
	else:
		try the actor fucking the likely organ with the second noun.

Redirect an actor fucking a person with something orificial (this is the redirect fucking a person with something orificial to fucking a body part rule):
	let the likely organ be the object produced by the default penile organ rules for the noun;
	if the likely organ is nothing:
		say "[The noun] [have] nothing obvious to fuck with." (A);
	else:
		try the actor fucking the likely organ with the second noun.

Check an actor fucking something with something (this is the can't fuck something with itself rule):
	if the noun is the second noun:
		issue failure message for the can't fuck something with itself rule;
		rule succeeds.

Check an actor fucking something with something (this is the can't fuck yourself with a part of yourself rule):
	if the noun is enclosed by the actor and the second noun is a body part enclosed by the actor:
		issue failure message for the can't fuck yourself with a part of yourself rule;
		rule succeeds.
		
Check an actor fucking something with something (this is the can't fuck with someone else's body part rule):
	if the second noun is a body part not enclosed by the actor:
		issue failure message for the can't fuck with someone else's body part rule;
		rule succeeds.

Check an actor fucking something with something (this is the can't fuck with a sex toy you don't have rule):
	if the second noun is a sex toy not enclosed by the actor:
		say "(first taking [the second noun])";
		silently try the actor taking the second noun;
		unless the second noun is carried by the actor:
			issue failure message for the can't fuck with a sex toy you don't have rule;
			rule succeeds.
	
Check an actor fucking something with something (this is the need to wear strap-ons before fucking with them rule):
	if the second noun is a strap-on and the second noun is not worn by the actor:
		say "(putting on [the second noun])";
		silently try wearing the second noun;
		unless the actor is not wearing the second noun:
			issue failure message for the need to wear strap-ons before fucking with them rule;
			rule succeeds.
				
Check an actor fucking something with something (this is the can't fuck yourself with a strap-on rule):
	if the noun is enclosed by the actor and the second noun is a strap-on:
		issue failure message for the can't fuck yourself with a strap-on rule;
		rule succeeds.

Check an actor fucking something with something (this is the can't fuck something not fuckable rule):
	if the noun is not fuckable:
		issue failure message for the can't fuck something not fuckable rule;
		rule succeeds.
	
Check an actor fucking something with something (this is the can't fuck with something not fuckable rule):
	if the second noun is not fuckable:
		issue failure message for the can't fuck with something not fuckable rule;
		rule succeeds.

Check an actor fucking something with something (this is the can't fuck with an invalid combination rule):
	follow the sexual combination validity rules;
	if the rule failed:
		rule succeeds.

Check an actor fucking something with something (this is the can't fuck a sex toy with a sex toy rule):
	if the noun is a sex toy and the second noun is a sex toy:
		issue failure message for the can't fuck a sex toy with a sex toy rule;
		rule succeeds.


Report an actor fucking something with something (this is the standard report fucking it with rule):
	say "[The actor] [fuck] [the noun] with [the second noun]."

Last unsuccessful attempt by someone fucking something with something (this is the suppress messages for failing to fuck something with something rule):
	stop the action.

Table of Failure Responses (continued)
rule name	message
the can't fuck something with itself rule	"[The person asked] [can't fuck] [the noun] with [themselves]."
the can't fuck yourself with a part of yourself rule	"[The person asked] [can't fuck] [themselves]."
the can't fuck with someone else's body part rule	"[The person asked] just [can't use] [the second noun] to fuck [regarding the person asked][themselves]."
the can't fuck with a sex toy you don't have rule	"[The person asked] [can't fuck] with [the second noun] without first holding [them] first."
the need to wear strap-ons before fucking with them rule	"[The person asked] [can't fuck] [themselves]."
the can't fuck yourself with a strap-on rule	"[The noun] [are] not something that can be fucked."
the can't fuck with something not fuckable rule	"[The second noun] [are] not something that can be fucked with."
the can't fuck a sex toy with a sex toy rule	"Fucking [the noun] with [the second noun] is a bit redundant, isn't it?"


Section - Combination Exceptions

The sexual combination validity rules are an action based rulebook. The sexual combination validity rules have outcomes combination valid (success) and combination invalid (failure).

Sexual combination validity for an actor fucking a face with a pussy (this is the permit women to face-fuck rule): combination valid.	
Sexual combination validity for an actor fucking a pussy with a pussy (this is the permit tribbing rule): combination valid.	
Sexual combination validity for an actor fucking a cock with a cock (this is the permit frotting rule): combination valid.
Sexual combination validity for an actor fucking a something orificial with something penile (this is the permit orificial sex rule): combination valid.
Sexual combination validity for an actor fucking a something penile with something orificial (this is the permit penile sex rule): combination valid.	

To work is a verb.

Last sexual combination validity rule (this is the sexual combination not applicable rule):
	say "[The noun] and [the second noun] [don't work] together." (A);
	combination invalid.

Persuasion rule for asking people to try fucking something with something: now the last fucktool is the second noun; persuasion succeeds.

[Unsuccessful attempt by someone fucking: stop the action.
Unsuccessful attempt by someone fucking something with something: stop the action.]

Chapter - Sexual Orientation

A person can be heterosexual, homosexual, or bisexual (this is its sexuality). A man is usually heterosexual. A woman is usually bisexual.

The sexual orientation rules are an action based rulebook.

Check an actor kissing a person (this is the wrong gender to kiss rule):
	follow the sexual orientation rules;
	if rule failed:
		rule succeeds.

Check an actor rubbing a body part (this is the wrong gender to rub rule):
	follow the sexual orientation rules;
	if rule failed:
		rule succeeds.

Check an actor licking a body part (this is the wrong gender to lick rule):
	follow the sexual orientation rules;
	if rule failed:
		rule succeeds.

Check an actor fucking a body part (this is the wrong gender to fuck rule):
	follow the sexual orientation rules;
	if rule failed:
		rule succeeds.
	
Check an actor fucking a body part with something (this is the wrong gender to fuck with rule):
	follow the sexual orientation rules;
	if rule failed:
		rule succeeds.

Section - Sexual Orientation Rules

A person has a text called the wrong sexuality message. The wrong sexuality message is usually "That's not going to happen."

Last sexual orientation rule (this is the can't do sexy things with people with incompatible sexualities rule):
	if the actor is not the sex partner:
		if the actor is not attracted to the sex partner:
			say "[Wrong sexuality message of the actor][paragraph break]" (A);
			rule fails;
		else if the sex partner is not attracted to the actor:
			say "[Wrong sexuality message of the sex partner][paragraph break]" (B);
			rule fails.


Section - Phrases about Sexuality

To decide whether (P - a person) doesn't like men: if P is a homosexual female or P is a heterosexual male, decide yes; decide no.
To decide whether (P - a person) doesn't like women: if P is a homosexual male or P is a heterosexual female, decide yes; decide no.
To decide whether (P - a person) is/are attracted to (N - a person):
	if P is bisexual:
		decide yes;
	if P is androphilic and N is male:
		decide yes;
	if P is gynephilic and N is female:
		decide yes;
	decide no.

To decide whether (P - a person) is/are not attracted to (N - a person):
	if P is bisexual:
		decide no;
	if P is androphilic and N is male:
		decide no;
	if P is gynephilic and N is female:
		decide no;
	decide yes.

Definition: a person is androphilic if it is homosexual male or it is heterosexual female or it is bisexual.
Definition: a person is gynephilic if it is heterosexual male or it is homosexual female or it is bisexual.

To say the/-- dispreferred gender of (x - person):
	if X doesn't like men:
		say "men";
	else:
		say "women".


Chapter - Willingness

The willingness rules are an action based rulebook. The willingness rules have outcomes unwilling (failure - the default) and willing (success).

Last check an actor rubbing something (this is the check rubbing willingness rule):
	follow the willingness rules;
	if the rule failed:
		rule fails.

Last check an actor licking something (this is the check licking willingness rule):
	follow the willingness rules;
	if the rule failed:
		rule fails.

Last check an actor fucking something with something (this is the check fucking willingness rule):
	follow the willingness rules;
	if the rule failed:
		rule fails.

Chapter - Sexual Behavior

Rubbing a body part is sexual behavior. Rubbing a sex toy is sexual behavior. Licking a body part is sexual behavior. Licking a sex toy is sexual behavior. Fucking is sexual behavior. Kissing is sexual behavior. Fucking something with something is sexual behavior. Titfucking is sexual behavior. Assfucking is sexual behavior. Masturbating is sexual behavior.

A person has a text called the generic sex refusal message. The generic sex refusal message is "Now is almost certainly not the time."

Persuasion rule for asking a person to try sexual behavior (this is the only can ask sex ready people to try sex rule):
	if the person asked is sex ready:
		persuasion succeeds;
	else:
		say the generic sex refusal message of the person asked;
		persuasion fails.

Part - Simpler Clothing

A person has a number called the worn layers. The worn layers is usually 1.
A person has a number called maximum worn layers. The maximum worn layers are usually 1.

When play begins (this is the populate maximum worn layers rule):
	repeat with N running through people:
		now the worn layers of N are the maximum worn layers of N.

Definition: a person is clothed if its worn layers are greater than 0.
Definition: a person is unclothed if its worn layers are 0.

[Understand "jacket/suit/coat/shirt/underwear/boxers/bra/panties/pants/trousers/sweater/socks/shoes/gloves" as "[piece of clothing]".

Understand "examine [piece of clothing]" as a mistake ("There is no need to examine individual pieces of clothing. Just examine the person instead.").
Understand "wear [piece of clothing]" as a mistake ("There is no need to wear individual pieces of clothing. Just use the DRESS command.").
Understand "take off [piece of clothing]", "remove [piece of clothing]", "shed [piece of clothing]" and "strip [piece of clothing]" as a mistake ("There is no need to remove individual pieces of clothing. Just type STRIP.").]


Chapter - Stripping and Dressing

Implied stripping is an action applying to nothing. Understand "strip", "take off clothes", "remove clothes" and "shed clothes" as implied stripping.

To dress is a verb.
To strip is a verb.

Check an actor implied stripping:
	try the actor stripping the actor instead.

Stripping is an action applying to one thing.
Understand "strip [something]" as stripping.
Understand the command "undress/disrobe" as "strip".


First check an actor stripping something (this is the can't strip objects rule):
	if the noun is not a person:
		issue failure message for the can't strip objects rule;
		rule succeeds.
Check an actor stripping something when the noun is unclothed (this is the can't strip if already naked rule):
	if the noun is the actor:
		issue failure message for the can't strip if already naked rule;
		rule succeeds.
Check an actor stripping something (this is the wrong gender to strip rule):
	follow the sexual orientation rules;
	if rule failed:
		rule succeeds.
	
Carry out an actor stripping something (this is the standard carry out stripping rule):
	decrement the worn layers of the noun.
	
Report an actor stripping something (this is the standard report stripping rule):
	if the noun is clothed:
		say "[The actor] [strip] off [regarding the noun][their] top layer of clothes." (A);
	else:
		say "[The actor] [strip] off all [regarding the noun][their] clothes." (B)

Last unsuccessful attempt by someone stripping (this is the suppress messages for failing to strip rule):
	stop the action

Dressing is an action applying to nothing.
Understand "dress" and "wear clothes" as dressing.

Check an actor dressing (this is the can't dress if already dressed rule):
	let N be the maximum worn layers of the actor;
	if the worn layers of the actor is at least N:
		issue failure message for the can't dress if already dressed rule;
		rule succeeds.
Check an actor dressing (this is the can't dress wearing a strap-on rule):
	if the actor is wearing a strap-on (called the item):
		issue failure message for the can't dress wearing a strap-on rule;
		rule succeeds.

Carry out an actor dressing (this is the standard carry out dressing rule):
	increment the worn layers of the actor.
	
Report an actor dressing (this is the standard report dressing rule):
	say "[The actor] [dress] in [their] clothes."

Check an actor wearing a strap-on (this is the must be naked to wear a strap-on rule):
	if the actor is clothed:
		issue failure message for the must be naked to wear a strap-on rule;
		rule succeeds.
	
Stripping something is sexual behavior. Implied stripping is sexual behavior. 

Last unsuccessful attempt by someone dressing (this is the suppress messages for failing to dress rule):
	stop the action.


Table of Failure Responses (continued)
rule name	message
the can't strip objects rule	"[The noun] [are] not something that can be stripped."
the can't strip if already naked rule	"[The person asked] [are] already naked."
the can't dress if already dressed rule	"[The person asked] [are] already dressed."
the can't dress wearing a strap-on rule	"[The person asked] [can't] [dress] while wearing a strap-on."
the must be naked to wear a strap-on rule	"[The person asked] must be naked before wearing [the noun]."

Chapter - Blocking Sex Acts Through Clothes

The particular part is an object that varies.

The clothing accessibility rules is a person based rulebook.

First clothing accessibility rule for a person (called K) (this is the clothing accessibility only applies to worn objects and parts of body rule):
	if the particular part is a wearable thing and the particular part is not worn by K:
		rule succeeds;
	if the particular part is not a part of K:
		rule succeeds.

Last clothing accessibility rule for a person (called K) (this is the default clothing accessibility rule):
	if K is clothed:
		rule fails;
	otherwise:
		rule succeeds.

The obstructed sex act rules are an action based rulebook. The obstructed sex act rules have default success.

Check an actor licking when the noun is enclosed by a clothed person (this is the can't lick under clothing rule):
	unless the noun is accessible:
		follow the obstructed sex act rules;
		stop the action.
Last obstructed sex act for an actor licking a noun (this is the default obstructed licking rule):
	say "[The actor] [can't lick] [the noun] underneath clothes." (A).
Check an actor fucking something with something (this is the can't fuck while clothed rule):
	if the noun is not accessible:
		follow the obstructed sex act rules;
		stop the action;
	if the second noun is not accessible:
		follow the obstructed sex act rules;
		stop the action.
Last obstructed sex act for an actor fucking something with something (this is the default actor obstructed fucking rule):
	if the noun is not accessible:
		say "[The actor] [can't fuck] [the noun] underneath clothes." (A);
	else if the second noun is not accessible:
		say "[The actor] [can't fuck] with [the second noun] underneath clothes." (B).
Check an actor fucking something with a sex toy (this is the can't fuck with sex toys under clothes rule):
	if the noun is not accessible:
		follow the obstructed sex act rules;
		stop the action.
Last obstructed sex act for an actor fucking something with a sex toy (this is the default obstructed sex toy fucking rule):
	say "[The actor] [can't fuck] [the noun] with [the second noun] underneath clothes." (A).

Section - Phrases to Determine What Body Parts are Clothed

To decide if (N - a thing) is accessible:
	if N is not a body part:
		decide yes;
	now the particular part is N;
	if a person (called K) encloses N:
		follow the clothing accessibility rules for K;
		if rule succeeded:
			decide yes;
	decide no.
To decide if (N - a thing) is not accessible:
	if N is accessible:
		decide no;
	decide yes.
[To decide if the actor is too clothed:
	if the actor's organ obstructed is true:
		decide yes;
	decide no.]

Part - Simple Willingness System

A person can be sex ready. A person is usually not sex ready. The player is sex ready.

First check an actor kissing a person (this is the can't kiss unwilling people rule):
	if the noun is not sex ready and the noun is not the player:
		say "[Generic sex refusal message of the noun][paragraph break]" (A) instead.
First check an actor licking a body part (this is the can't lick unwilling people rule):
	if the holder of the noun is not sex ready and the holder of the noun is not the player:
		say "[Generic sex refusal message of the holder of the noun][paragraph break]" (A) instead.
First check an actor fucking a body part (this is the can't fuck unwilling people rule):
	if the holder of the noun is not sex ready and the holder of the noun is not the player:
		say "[Generic sex refusal message of the holder of the noun][paragraph break]" (A) instead.
First check an actor rubbing a body part (this is the can't rub unwilling people rule):
	if the holder of the noun is not sex ready and the holder of the noun is not the player:
		say "[Generic sex refusal message of the holder of the noun][paragraph break]" (A) instead.
First check an actor fucking a body part with something (this is the can't fuck unwilling people with something rule):
	if the holder of the noun is not sex ready and the holder of the noun is not the player:
		say "[Generic sex refusal message of the holder of the noun][paragraph break]" (A) instead.

First check someone kissing (this is the can't get unwilling people to kiss rule):
	if the actor is not sex ready:
		say "[Generic sex refusal message of the actor][paragraph break]" (A) instead.
First check someone licking a body part (this is the can't get unwilling people to lick rule):
	if the actor is not sex ready:
		say "[Generic sex refusal message of the actor][paragraph break]" (A) instead.
First check someone fucking a body part (this is the can't get unwilling people to fuck rule):
	if the actor is not sex ready:
		say "[Generic sex refusal message of the actor][paragraph break]" (A) instead.
First check someone rubbing a body part (this is the can't get unwilling people to rub rule):
	if the actor is not sex ready:
		say "[Generic sex refusal message of the actor][paragraph break]" (A) instead.
First check someone fucking a body part with something (this is the can't get unwilling people to fuck with something rule):
	if the actor is not sex ready:
		say "[Generic sex refusal message of the actor][paragraph break]" (A) instead.

Part - Sex Action Tracking

Chapter - Tracking

Section - Tracking Fucking

Fuck-tracking relates things to each other.
The verb to previously fuck (he previously fucks, they previously fuck, he previously fucked, it is previously fucked, he is previously fucking) implies the fuck-tracking relation.

Post-action bookkeeping an actor fucking something with something (this is the track fucking rule):
	now the actor previously fucks the noun;
	now the second noun previously fucks the noun;
	if the noun is enclosed by a person (called the individual):
		now the individual previously fucks the second noun.

Post-action bookkeeping an actor fucking a face with something(this is the reciprocate tracking fucking a face rule):
	now the holder of the noun previously licks the second noun.

Section - Tracking Licking

Lick-tracking relates various people to various things.
The verb to previously lick (he previously licks, they previously lick, he previously licked, it is previously licked, he is previously licking) implies the lick-tracking relation.

Post-action bookkeeping an actor licking a body part (this is the track licking rule):
	now the actor previously licks the noun.

Post-action bookkeeping an actor licking a fuckable thing (this is the reciprocate tracking licking a cock rule):
	if the actor encloses a face and the noun is enclosed by a person (called the individual):
		now the individual previously fucks the face of the actor;
		now the noun previously fucks the face of the actor.

Section - Tracking Rubbing

Rub-tracking relates various people to various things.
The verb to previously rub (he previously rubs, they previously rub, he previously rubbed, it is previously rubbed, he is previously rubbing) implies the rub-tracking relation.

Post-action bookkeeping an actor rubbing a body part (this is the track rubbing rule):
	now the actor previously rubs the noun.

Section - Tracking Kissing

Kiss-tracking relates various people to each other.
The verb to previously kiss (he previously kisses, they previously kiss, he previously kissed, it is previously kissed, he is previously kissing) implies the kiss-tracking relation.

Post-action bookkeeping an actor kissing a person (this is the track kissing rule):
	now the actor previously kisses the noun.

Section - Phrases to Determine Prior Sexual Activity

To decide if (N - a person) has fucked any part of (X - a person):
	repeat with L running through sexable body parts incorporated by X:
		if N previously fucks L:
			decide yes;
	decide no.

To decide if (N - a person) has licked any part of (X - a person):
	repeat with L running through sexable body parts incorporated by X:
		if N previously licks L:
			decide yes;
	decide no.

To decide if (N - a person) has rubbed any part of (X - a person):
	repeat with L running through sexable body parts incorporated by X:
		if N previously rubs L:
			decide yes;
	decide no.

To decide if any sexual activity occurred between (N - a person) with (X - a person):
	if N has fucked any part of X, decide yes;
	if N has licked any part of X, decide yes;
	if N has rubbed any part of X, decide yes;
	if N previously kisses X, decide yes;
	decide no.

Chapter - Sex Scenes

A scene can be erotic. A scene is usually not erotic.
A scene has a list of people called the involved partners.

When a erotic scene (called K) begins:
	repeat with P running through the involved partners of K:
		now P previously fucks nothing;
		repeat with L running through body parts incorporated by P:
			now L previously fucks nothing;
		now P previously licks nothing;
		now P previously rubs nothing;
		now P previously kisses nothing;
		now P is sex ready;
	now the player previously fucks nothing;
	now the player previously licks nothing;
	now the player previously rubs nothing;
	now the player previously kisses nothing.

When an erotic scene (called K) ends:
	repeat with P running through the involved partners of K:
		if P is not the player:
			now P is not sex ready.

Part - Sex Memory by Dudeman

The previous action is a stored action that varies. The last action is a stored action that varies. The acting action is a stored action that varies.
The action repeat count is a number that varies.

action memory is a truth state that varies. action memory is usually false.

examining something is actionless acting. looking is actionless acting. taking inventory is actionless acting. looking is actionless acting.

Chapter - Post-action bookkeeping rule


This is the post-action bookkeeping stage rule:
	if the action in world is true:
		follow the post-action bookkeeping rules.


The post-action bookkeeping stage rule is listed after the report stage rule in the specific action-processing rulebook.
[The post-action bookkeeping stage rule is listed before the carry out stage rule in the specific action-processing rulebook.]
[The post-action bookkeeping stage rule is listed after the carry out stage rule in the specific action-processing rulebook.]

The post-action bookkeeping rules are an action based rulebook.

Chapter - Mid-action bookkeeping rule

The mid-action bookkeeping rules are an action based rulebook.
This is the mid-action bookkeeping stage rule:
	if action in world is true, follow the mid-action bookkeeping rules.
The mid-action bookkeeping stage rule is listed before the carry out stage rule in the specific action-processing rulebook.

Mid-action bookkeeping rule for an actor doing something (this is the checking for action continuation rule):
	unless we are actionless acting:
		now the last action is the current action;
		now action memory is true;
		if the current action is the previous action:
			increment the action repeat count;
		else:
			now the action repeat count is 1;
		continue the action.

Chapter - Pre-action bookkeeping rule

This is the pre-action bookkeeping stage rule:
	follow the pre-action bookkeeping rules.
The pre-action bookkeeping stage rule is listed before the before stage rule in the action-processing rulebook.

The pre-action bookkeeping rules are an action based rulebook.

A pre-action bookkeeping rule for an actor doing something (this is the change the acting action to the current action rule):
	now the acting action is the current action.


Section - Phrases to Track Prior Actions

Before reading a command while action memory is true:
	now the previous action is the last action;
	now action memory is false.

to decide if continuing the action: if the the previous action is the acting action begin; yes; otherwise; no; end if.

to capture the action (deprecated): now the previous action is the current action.

To treat action as success:
	follow the mid-action bookkeeping rulebook;
	follow the post-action bookkeeping rulebook.

Part - Disambiguation


Chapter - Clarifying During Orgy Scenes

The last partner specified is an object that varies.

Post-action bookkeeping an actor fucking a body part (this is the mark the person fucked as the last partner specified rule):
	unless the noun is a part of the actor:
		if the actor is the player:
			if the noun is enclosed by a person (called N):
				now the last partner specified is N;
		else if the noun is enclosed by the player:
			now the last partner specified is N.

Post-action bookkeeping an actor licking a body part (this is the mark the person licked as the last partner specified rule):
	unless the noun is part of the actor:
		if the actor is the player:
			if the noun is enclosed by a person (called N) and N is not the player:
				now the last partner specified is N;
		else if the noun is enclosed by the player:
			now the last partner specified is the actor.

Post-action bookkeeping an actor rubbing a body part (this is the mark the person rubbed as the last partner specified rule):
	unless the noun is part of the actor:
		if the actor is the player:
			if the noun is enclosed by a person (called N) and N is not the player:
				now the last partner specified is N;
		else if the noun is enclosed by the player:
			now the last partner specified is the actor.
		
Post-action bookkeeping an actor kissing (this is the mark the person kissed as the last partner specified rule):
	if the actor is the player:
		now the last partner specified is the noun;
	else if the noun is the player:
		now the last partner specified is the actor.

First persuasion rule for asking a person to try sexual behavior (this is the mark the person asked for sexy stuff as the last partner specified rule):
	if the person asked is male and the player doesn't like women:
		now (the last partner specified) is (the person asked);
	if the person asked is female and the player doesn't like men:
		now the last partner specified is the person asked.




Part - Original Disambiguation (for use without Disambiguation Control by Jon Ingold)

Does the player mean fucking something with a body part enclosed by the player (this is the assume the player means to fucking something with their own body part rule): it is likely.
Does the player mean asking someone (called the bwner) to try fucking something with a body part (called the part) (this is the assume the player means to ask someone to try fucking something with their own body part rule):
	if the part is enclosed by a person (called the owner):
		if the owner is the bwner, it is likely.
Does the player mean examining, fucking, licking or rubbing a body part enclosed by the player (this is the assume the player doesn't mean to do funny stuff with themselves rule): it is unlikely.
Does the player mean examining, fucking, licking or rubbing a body part enclosed by a male person when the player doesn't like men (this is the assume the player doesn't mean to do funny stuff with men when they don't like men rule):
	it is very unlikely.
Does the player mean examining, fucking, licking or rubbing a body part enclosed by a female person when the player doesn't like women (this is the assume the player doesn't mean to do funny stuff with women when they don't like women rule):
	it is very unlikely.
Does the player mean fucking a body part enclosed by a male person with something when the player doesn't like men (this is the assume the player doesn't mean to fuck men with something when they don't like men rule):
	it is very unlikely.
Does the player mean fucking a body part enclosed by a female person with something when the player doesn't like women (this is the assume the player doesn't mean to fuck women with something when they don't like women rule):
	it is very unlikely.
Does the player mean fucking a body part enclosed by (the last partner specified) (this is the assume that the player means to fuck the last person they interacted with rule):
	if the last partner specified is not visible, it is very unlikely;
	if the last partner specified is not a person, it is very unlikely;
	it is very likely.
Does the player mean licking a body part enclosed by (the last partner specified) (this is the assume that the player means to lick the last person they interacted with rule):
	if the last partner specified is not visible, it is very unlikely;
	if the last partner specified is not a person, it is very unlikely;
	it is very likely.
Does the player mean rubbing a body part enclosed by (the last partner specified) (this is the assume that the player means to rub the last person they interacted with rule):
	if the last partner specified is not visible, it is very unlikely;
	if the last partner specified is not a person, it is very unlikely;
	it is very likely.
Does the player mean fucking a body part enclosed by (the last partner specified) with something (this is the assume that the player means to fuck the last person with something they interacted with rule):
	if the last partner specified is not visible, it is very unlikely;
	if the last partner specified is not a person, it is very unlikely;
	it is likely.
Does the player mean examining a person (this is the assume the player wants to examine the whole person rule): it is likely.

Part - Better Disambiguation (for use with Disambiguation Control by Jon Ingold)

Should the game suggest examining a body part incorporated by the player (this is the assume the player doesn't want to examine themselves rule): never.
Should the game suggest examining a body part incorporated by a male person when the player is androphilic (this is the assume the player wants to examine men when the player is attracted to men rule): it is a good suggestion.
Should the game suggest examining a body part incorporated by a female person when the player is gynephilic (this is the assume the player wants to examine women when the player is attracted to women rule): it is a good suggestion.
Should the game suggest examining a body part incorporated by a last partner specified (this is the assume the player wants to examine the last partner specified rule): it is an excellent suggestion.

Should the game suggest rubbing a body part incorporated by a male person when the player is androphilic (this is the assume the player wants to rub men when the player is attracted to men rule): it is a good suggestion.
Should the game suggest rubbing a body part incorporated by a female person when the player is gynephilic (this is the assume the player wants to rub women when the player is attracted to women rule): it is a good suggestion.
Should the game suggest rubbing a body part incorporated by a last partner specified (this is the assume the player wants to rub the last partner specified rule): it is an excellent suggestion.
Should the game suggest asking a person to try rubbing a body part incorporated by the person asked (this is the assume the player wants to ask people to rub themselves rule): it is an excellent suggestion.
Should the game suggest asking a person to try rubbing a body part incorporated by the player (this is the assume the player wants to ask people to rub the player rule): it is a good suggestion.
Should the game suggest rubbing a body part incorporated by the player (this is the assume the player doesn't want to rub themselves rule): it is a bad suggestion.

The assume the player doesn't want to rub themselves rule is listed first in the should the game suggest rulebook.

Should the game suggest licking a body part incorporated by a male person when the player is androphilic (this is the assume the player wants to lick men when the player is attracted to men rule): it is a good suggestion.
Should the game suggest licking a body part incorporated by a female person when the player is gynephilic (this is the assume the player wants to lick women when the player is attracted to women rule): it is a good suggestion.
Should the game suggest licking a body part incorporated by a last partner specified (this is the assume the player wants to lick the last partner specified rule): it is an excellent suggestion.
Should the game suggest asking a person to try licking a body part incorporated by the person asked (this is the assume the player doesn't want to ask people to lick themselves rule): it is a bad suggestion.
Should the game suggest asking a person to try licking a body part incorporated by the player (this is the assume the player wants to ask people to lick the player rule): it is a good suggestion.
Should the game suggest licking a body part incorporated by the player (this is the assume the player doesn't want to lick themselves rule): it is a bad suggestion.

The assume the player doesn't want to lick themselves rule is listed first in the should the game suggest rulebook.

Should the game suggest fucking a body part incorporated by a male person when the player is androphilic (this is the assume the player wants to fuck men when the player is attracted to men rule): it is a good suggestion.
Should the game suggest fucking a body part incorporated by a female person when the player is gynephilic (this is the assume the player wants to fuck women when the player is attracted to women rule): it is a good suggestion.
Should the game suggest fucking a body part incorporated by a last partner specified (this is the assume the player wants to fuck the last partner specified rule): it is an excellent suggestion.
Should the game suggest asking a person to try fucking a body part incorporated by the person asked (this is the assume the player doesn't want to ask people to fuck themselves rule): never.
Should the game suggest asking a person to try fucking a body part incorporated by the player (this is the assume the player wants to ask people to fuck the player rule): it is a good suggestion.
Should the game suggest fucking a body part incorporated by the player (this is the assume the player doesn't want to fuck themselves rule): it is a bad suggestion.

The assume the player doesn't want to fuck themselves rule is listed first in the should the game suggest rulebook.

Should the game suggest fucking a body part incorporated by a male person with something when the player is androphilic (this is the assume the player wants to fuck men with something when the player is attracted to men rule): it is a good suggestion.
Should the game suggest fucking a body part incorporated by a female person with something when the player is gynephilic (this is the assume the player wants to fuck women with something when the player is attracted to women rule): it is a good suggestion.
Should the game suggest fucking a body part incorporated by a last partner specified with something (this is the assume the player wants to fuck the last partner specified with something rule): it is an excellent suggestion.
Should the game suggest asking a person to try fucking a body part enclosed by the person asked with something (this is the assume the player doesn't want to ask people to fuck themselves with something rule): never.
Should the game suggest asking a person to try fucking something with something not enclosed by the person asked (this is the assume the player doesn't want to ask people to fuck something with something not a part of themselves rule): never.
Should the game suggest asking a person to try fucking a body part incorporated by the player with something (this is the assume the player wants to ask people to fuck the player with something rule): it is a good suggestion.
Should the game suggest fucking something with a body part incorporated by the player (this is the assume the player wants to fuck people with its own body part rule): it is a good suggestion.
Should the game suggest fucking a body part incorporated by the player with something (this is the assume the player doesn't want to fuck themselves with something rule): it is a bad suggestion.

The assume the player doesn't want to fuck themselves with something rule is listed first in the should the game suggest rulebook.

Part - Debugging and Testing (not for release)

Chapter - Sexual Interactions Test

Testing it rub-interaction on is an action applying to two things. Understand "rub-test [a person] on [a person]" as testing it rub-interaction on.

Carry out testing a person rub-interaction on a person:
	say "TEST -- [the noun] rubbing [the second noun]...[paragraph break]";
	repeat with K running through body parts enclosed by the second noun:
		say "[italic type][The noun] rubbing [the K][roman type]:[line break]";
		try the noun rubbing K.

Testing it lick-interaction on is an action applying to two things. Understand "lick-test [a person] on [a person]" as testing it lick-interaction on.

Carry out testing a person lick-interaction on a person:
	say "TEST -- [the noun] licking [the second noun]...[paragraph break]";
	repeat with K running through body parts enclosed by the second noun:
		say "[italic type][The noun] licking [the K][roman type]:[line break]";
		try the noun licking K.

Testing it fuck-interaction on is an action applying to two things. Understand "fuck-test [a person] on [a person]" as testing it fuck-interaction on.

Carry out testing a person fuck-interaction on a person:
	say "TEST -- [the noun] fucking [the second noun]...[paragraph break]";
	repeat with K running through body parts enclosed by the noun:
		repeat with L running through body parts enclosed by the second noun:
			say "[italic type][The noun] fucking [the l] with [the k][roman type]:[line break]";
			try the noun fucking L with K.

Testing sexual interactions is an action applying to two things. Understand "sex-test [a person] on [a person]" as testing sexual interactions.

Chapter - Integrating Object Response Tests (for use with Object Response Tests by Juhana Leinonen)

The tested fucktool is an object that varies. The tested fucktool is usually your cock.

Switching tested tools is an action out of world applying to one thing. Understand "tested fucktool [something]" as switching tested tools.

Carry out switching tested tools (this is the switch out fucktool rule):
	now the noun is the tested fucktool.
	
Report switching tested tools (this is the report switching out fucktools rule):
	say "OK now you are using [the noun] to test fucking."
 
Table of Analyzing Actions (continued)
topic	testing rule
"licking"	test licking rule
"fucking"	test fucking rule
"fucking it with"	test fucking it with rule

This is the test licking rule:
	announce tests for "licking [the noun]";
	try the test-actor licking the noun.

This is the test fucking rule:
	announce tests for "fucking [the noun]";
	try the test-actor fucking the noun.

This is the test fucking it with rule:
	announce tests for "fucking [the noun] with [the tested fucktool]";
	try the test-actor fucking the noun with the tested fucktool.

Section - Testing Clothing (for use without Advanced Layered Clothing by Another Wannabe)

Table of Analyzing Actions (continued)
topic	testing rule
"stripping"	test stripping rule
"dressing"	test dressing rule

This is the test stripping rule:
	announce tests for "stripping [the noun]";
	try the test-actor stripping the noun.

This is the test dressing rule:
	announce tests for "dressing";
	try the test-actor dressing.

Part - Carrying Requirement Manipulation

The remove carrying requirements is a truth state that varies.

To toggle off carrying requirements:
	now remove carrying requirements is true.

Pre-action bookkeeping rule for an actor showing a body part[ enclosed by the actor] to something (this is the ignore carrying requirements for showing one's own body parts rule):
	toggle off carrying requirements.

The carrying requirements rule does nothing if the remove carrying requirements is true.

This is the reinstate carrying requirements rule:
	now remove carrying requirements is false.

The reinstate carrying requirements rule is listed after the carrying requirements rule in the action-processing rules.

Part - Sex Commands in CYOA (for use with Hybrid Choices by AW Freyr)

After reading a command when in cyoa mode (this is the accept sex commands rule):
	if the player's command includes "fuck/lick/suck/rub/massage/strip/dress":
		now the command accepted is true.

Part - Plug-ins

Chapter - Default Clothing Behavior Plug-in

[This adds some default clothing behavior to all players if no clothing accessibility rules are written for a person. Basically, the game assumes that every character is wearing a shirt and pants at worn layers 2, and underwear (bra and panties for women, underwear for men) at worn layers 1. Requires the common body parts plug-in.]

[***PLUG-IN BEGINS -- UNCOMMENT EVERYTHING BELOW***]

[Last clothing accessibility rule for a person (called K) when the worn layers of K are 2 (this is the shirt and pants rule):
	if the particular part are breasts or the particular part is an ass or the particular part is a pussy or the particular part is a cock or the particular part are legs or the particular part is a tummy or the particular part is a chest:
		rule fails;
	rule succeeds.
Last clothing accessibility rule for a person (called K) when the worn layers of K are 1 (this is the down to underwear rule):
	if the particular part are breasts or the particular part is an ass or the particular part is a pussy or the particular part is a cock:
		rule fails;
	rule succeeds.]

[***PLUG-IN ENDS -- UNCOMMENT EVERYTHING ABOVE***]


Chapter - Public/Private Areas by Dudeman Plug-in

[This plug-in was originally part of the core Simpler AIF extension, but the functionality was too specific to be useful to all AIF authors, and I generally found it got in the way of what I was intending. This plug-in defines an area as either public or private -- sex can't be performed while in view of a non-sex ready person]

[***PLUG-IN BEGINS -- UNCOMMENT EVERYTHING BELOW***]

[A room is either private or public. A room is usually public.

A person has a text called the too public message. The too public message of a person is usually "It [if the story tense is present tense]is[else]was[end if] a little too public to be trying that.".

to decide whether in public: if a not sex ready person is visible, decide yes; if the player is enclosed by a public room, decide yes; if the player is in a private room, decide no.

Check an actor going to a room (called the place) while the actor is unclothed (this is the can't walk into a public area indecent rule):
	say "[The actor] [shouldn't go] into public dressed like that." (A) instead.

Check an actor rubbing a body part enclosed by a person (called the bwner) while the location of the actor is public (this is the can't rub someone in public rule):
	say "[Too public message of the actor][paragraph break]" (A) instead.

Check an actor rubbing a sex toy while the location of the actor is public (this is the can't rub sex toys in public rule):
	say "[Too public message of the actor][paragraph break]" (A) instead.

Check an actor licking a body part enclosed by a person (called the bwner) while the location of the actor is public (this is the can't lick someone in public rule):
	say "[Too public message of the actor][paragraph break]" (A) instead.

Check an actor licking a sex toy while the location of the actor is public (this is the can't lick sex toys in public rule):
	say "[Too public message of the actor][paragraph break]" (A) instead.

Check an actor fucking a body part enclosed by a person (called the bwner) while the location of the actor is public (this is the can't fuck someone in public rule):
	say "[Too public message of the actor][paragraph break]" (A) instead.

Check an actor fucking a body part enclosed by a person (called the bwner) with something while the location of the actor is public (this is the can't fuck someone with something in public rule):
	say "[Too public message of the actor][paragraph break]" (A) instead.

Check an actor stripping while the location of the actor is public (this is the can't strip in public rule):
	say "[Too public message of the actor][paragraph break]" (A) instead.]

[***PLUG-IN ENDS -- UNCOMMENT EVERYTHING ABOVE***]

Chapter - Custom Body Part Names Plug-in

[This plug-in allows authors to define their own names for default body parts. For some authors, "pussy" is a little too obscene... for other, not obscene enough. A text variable is provided for each body part in the format Default (Body Part) Name, so now you can write Now the Default Pussy Name is "vagina". As a bonus, the printed body part name of the last partner specified will be "her body part" or "his body part". Remember to provide Understand rules if you name them something particularly exotic]

Section - Core Body Parts

[***PLUG-IN BEGINS -- UNCOMMENT EVERYTHING BELOW***]

[Include (-

[ CAPITALIZING_MODE ; 
	return caps_mode;
];

-) after "Printing.i6t"

To decide whether capitalizing: (- (CAPITALIZING_MODE() ) -).

To say the/-- preamble for (K - a person):
	unless capitalizing:
		if K is the last partner specified:
			say "[regarding K][their]";
		else if K is the player:
			say "your";
		else:
			say "[the k]'s";
	else:
		if K is the last partner specified:
			say "[regarding K][their]";
		else if K is the player:
			say "Your";
		else:
			say "[The K]'s".

The default pussy name is a text variable. The default pussy name is "pussy".
The default breasts name is a text variable. The default breasts name are "breasts".
The default ass name is a text variable. The default ass name is "ass".
The default cock name is a text variable. The default cock name is "cock".

Rule for printing the name of a pussy (called J):
	if J is enclosed by a person (called K):
		say "[preamble for K] [default pussy name]".

Rule for printing the name of breasts (called J):
	if J is enclosed by a person (called K):
		say "[preamble for K] [default breasts name]".

Rule for printing the name of ass (called J):
	if J is enclosed by a person (called K):
		say "[preamble for K] [default ass name]".

Rule for printing the name of cock (called J):
	if J is enclosed by a person (called K):
		say "[preamble for K] [default cock name]".

The default hair name is a text variable. The default hair name is "hair".
The default face name is a text variable. The default face name is "face".
The default eyes name is a text variable. The default eyes name is "eyes".
The default legs name is a text variable. The default legs name is "legs".
The default tummy name is a text variable. The default tummy name is "tummy".
The default chest name is a text variable. The default chest name is "chest".
The default arms name is a text variable. The default arms name is "arms".

Rule for printing the name of hair (called J):
	if J is enclosed by a person (called K):
		say "[preamble for K] [default hair name]".

Rule for printing the name of face (called J):
	if J is enclosed by a person (called K):
		say "[preamble for K] [default face name]".

Rule for printing the name of eyes (called J):
	if J is enclosed by a person (called K):
		say "[preamble for K] [default eyes name]".

Rule for printing the name of legs (called J):
	if J is enclosed by a person (called K):
		say "[preamble for K] [default legs name]".

Rule for printing the name of tummy (called J):
	if J is enclosed by a person (called K):
		say "[preamble for K] [default tummy name]".

Rule for printing the name of chest (called J):
	if J is enclosed by a person (called K):
		say "[preamble for K] [default chest name]".

Rule for printing the name of arms (called J):
	if J is enclosed by a person (called K):
		say "[preamble for K] [default arms name]".

The default hands name is a text variable. The default hands name is "hands".
The default feet name is a text variable. The default feet name is "feet".

Rule for printing the name of hands (called J):
	if J is enclosed by a person (called K):
		say "[preamble for K] [default hands name]".

Rule for printing the name of feet (called J):
	if J is enclosed by a person (called K):
		say "[preamble for K] [default feet name]".]

[***PLUG-IN ENDS -- UNCOMMENT EVERYTHING ABOVE***]

Chapter - Clothing Sets
			
[***PLUG-IN BEGINS -- UNCOMMENT EVERYTHING BELOW***]

[
A clothing set is a kind of thing. A clothing set is always wearable. The regular clothes are a clothing set. Understand "clothes/clothing/garments" as a clothing set.

A clothing set has a number called the maximum worn layers. The maximum worn layers is usually 2. A clothing set has a number called the worn layers.
A person has an object called the outfit. The outfit is usually nothing. A person has an object called the previously worn outfit. The previously worn outfit is usually nothing.

Understand "take off [a clothing set]" as stripping. Understand "take [a clothing set] off" as stripping. Understand "remove [a clothing set]" as stripping. Understand "shed [a clothing set]" as stripping.

To have (X - a person) change into (Y - a clothing set):
	unless the outfit of X is nothing:
		now the previously worn outfit of X is the outfit of X;
	now the outfit of X are Y;
	now the maximum worn layers of X are the maximum worn layers of Y;
	now the worn layers of X are the maximum worn layers of X;
	now the worn layers of Y are the maximum worn layers of Y.

The stripping action has an object called the outfit taken off.

Carry out an actor stripping a person when the noun wears a clothing set (called K) (this is the take off clothing sets when they aren't worn rule):
	decrement the worn layers of K;
	if the worn layers of K are 0:
		now the previously worn outfit is the outfit of the noun;
		now the outfit taken off is the outfit of the noun;
		if the noun is the player:
			now the noun is carrying K;
		else:
			now K is in the location of the noun;
		now the outfit of the noun is nothing;
		now the maximum worn layers of the noun is 0.

Before an actor dressing when the maximum worn layers of the actor are 0 (this is the attempt find an outfit to dress into rule):
	let the potential outfit be an object;
	if the previously worn outfit of the actor is carried by the actor:
		now the potential outfit is the previously worn outfit of the actor;
	else if ((the previously worn outfit) of (the actor) is visible) and (the previously worn outfit of the actor is carried by nothing):
		now the potential outfit is the previously worn outfit of the actor;
	else if actor carries a clothing set (called K):
		now the potential outfit is K;
	if the potential outfit is nothing:
		say "There's nothing obvious for [the actor] to change into.";
		stop the action;
	else:
		try the actor wearing the potential outfit;
		stop the action.

The wearing action has a object called the outfit replaced.

First carry out an actor wearing a clothing set (this is the dispose of the previous outfit rule):
	unless the outfit of the actor is nothing:
		now the outfit replaced is the outfit of the actor;
		if the actor is not the player:
			now the outfit of the actor is in the location of the actor;
		else if the actor is the player:
			say "(first taking off [the outfit of the actor])";
			now the outfit of the actor is carried by the player;
	else:
		now the outfit replaced is nothing.
Carry out an actor wearing a clothing set (this is the have the actor change into a new clothing set rule):
	have the actor change into the noun.

Report an actor wearing a clothing set (this is the report an actor changing into a new clothing set rule):
	say "[The actor] [put] on [the noun].";
	rule succeeds.

The populate maximum worn layers rule is not listed in the when play begins rulebook.
When play begins (this is the populate maximum worn layers rule including outfits rule):
	repeat with X running through people:
		if X is wearing a clothing set (called K):
			now the outfit of X is K;
			now the maximum worn layers of the X is the maximum worn layers of K;
			now the worn layers of the X is the maximum worn layers of the X;
			now the worn layers of K is the maximum worn layers of K;
		else:
			now the worn layers of X is the maximum worn layers of X.

The outfit accessibility rules are a clothing set based rulebook.

First clothing accessibility rule for a person (called K) (this is the redirect to other clothing rule):
	unless the outfit of K is nothing or the worn layers of K is 0:
		abide by the outfit accessibility rules for the outfit of K.]

[***PLUG-IN ENDS -- UNCOMMENT EVERYTHING ABOVE***]

[Redirect an actor fucking something penile with something orificial (this is the penile-focused fucking rule):
	if the noun is enclosed by a person (called the individual):
		try the individual fucking the second noun with the noun;
	else:
		continue the action.]

[Redirect an actor fucking something orificial with something penile (this is the orifice-focused fucking rule):
	if the noun is enclosed by a person (called the individual):
		try the individual fucking the second noun with the noun;
	else:
		continue the action.]

Simpler AIF ends here.

---- DOCUMENTATION ----

Chapter: Introduction

Section: Acknowledgments and Contact Information

A very special thanks to Dudeman. This extension was built off of Dudeman's General AIF, and saved me a lot of hair-pulling, bug testing and time.

Thanks to Hanon Ondricek, who provided many great suggestions and assisted with bug testing.

Thanks to Shadow Wolf, who let me use some of his code from his extensions.

Please submit comments, suggestions and bug reports to AnotherWannabe93@gmail.com.

You can check for updates, download my games and read developer diaries at awaifgames.blogspot.com.

Other compatible AIF extensions:

	Advanced Layered Clothing by Another Wannabe (adds a complex layered clothing system to Simpler AIF)
	Orgasms and Arousal by Another Wannabe (adds an arousal system)
	Improved Sex Action Tracking by Another Wannabe (adds a less memory intensive action tracking system)
	Posturing by Another Wannabe (add furniture and postures)
	Penetration by Another Wannabe (allows for some complex mechanics, requires Orgasms and Arousal)
	What an Ass (adds some ass-specific features (heh) such as the buttocks)

Special interactions with non-AIF extensions. Include these before Simpler AIF.

	Object Response Tests by Juhana Leinonen (adds the various new actions to the object response tests)
	Hybrid Choices by AW Freyr (adds support for CYOA games. I authored this extension, too.)
	Disambiguation Control by Jon Ingold (improves disambiguation) (HIGHLY RECOMMENDED)

Section: Foreward

This title of this extension is a bit misleading. There's no such thing a "simple" interactive sex scene. Simpler AIF aims to be just that: "simpler". Because it is simpler, it is easier to learn and there's less fiddly moving bits that could break. You'll find Simpler AIF to be faster and less memory intensive than similar and more complicated AIF extensions. On the other hand, many of the features expected of most AIF extensions (i.e. layered clothing) are not present or are available in a very simplified form.

The documentation has been completely rewritten . The first part is a step-by-step tutorial for writing a full sex scene that goes over the basics of AIF writing. The second part is some documentation on how you can customize different aspects of the extension, including adding new body parts, actions and other things, and a discussion of some advanced features. The third part is a reference with a comprehensive index of various aspects of the extension. The fourth part is a repository of some optional plug-ins.

Section: Important Update Information from Version 12

The old library message is back in, but in slightly altered form. This time, it's easier to change the text of default messages. It is mostly managed through a table called the Table of Failure Responses. This will be covered in a later section of this documentation.

Version 13 includes a new method for determining sexuality. The old method was pretty complex. Now there is a rulebook dedicated to determining whether sexual orientations are compatible. When making your own actions, use something like this:

	Check fnarding:
		unless the sex partner is the actor:
			follow the sexual orientation rules;
			if rule fails:
				rule failed.

Section: Version Information

	Version 16, February 10th, 2015
	-- Fixed bug that doubles body parts when the player is not yourself at the beginning of the game (thanks to bug tester)

	Version 15, November 18th, 2014
	-- Added the Willingness rules.

	Version 14, September 11th, 2014
	-- Added flashing back in, removed Ignored Rules by Ron Newcomb as a dependency.
	-- Lessened capitalization issues with the Custom Body Part Names plugin.
	-- Added vibrators and vibrating strap-ons.
	
	Version 13, July 30th, 2014
	-- Improved disambiguation for bisexual PCs.
	-- Added support for Hybrid Choices extension.
	-- Added more descriptive name for sexuality and body descriptors.
	-- Changed the message system again.
	-- Made "sex partner" be chosen when run rather than a stored value.
	-- New method for deciding if sexual orientation stops an action.
	
	Version 12, June 18th, 2014
	-- Updated SAIF for the new version of Inform 7.
	-- Removed AIF Message system and implemented the new one.
	-- "The failer" variable is obsolete and has been removed.
	-- Support for flashing temporarily withdrawn.

	Version 11, March 22nd, 2014
	-- Added a new "sex partner" variable.
	-- Changed a lot of logic to make use of the "sex partner" variable.
	-- Added a new library message for attempts to masturbate without a cock or pussy.
	-- Fixed a rare bug where an attempt to fuck a face with a face resulted in the actor kissing themselves.

	Version 10, March 10th, 2014
	-- Faces have been made orificial.
	-- Some previously unnamed rules have been given names.
	-- A typo was corrected in one of the pastable sections of code, causing it not to compile. Thanks to the person who pointed that out.

	Version 9, February 16th, 2014
	-- Added phrases to find feet and hands.
	-- Fucking with hands now redirects to rubbing.
	-- Added a mid-action bookkeeping rulebook.
	-- Fixed a bug related to sex action tracking.

	Version 8, January 26th, 2014
	-- Fixed an embarrassing bug which broke the fucking action.

	Version 7, January 20th, 2014
	-- Improved disambiguation.
	-- Rewrote fucking action so that it reroutes to a fucking it with command.
	-- Rewrote the fucking it with command.
	-- Rewrote the assfucking and titfucking commands.
	-- Added support for frotting and tribadism.
	-- Added support for sex toys.
	-- Allowed fucking something with breasts or ass.
	-- Updated the sex-tracking relations.
	-- Removed the "sexable" condition for body parts and replaced it with "orificial", "penile", "sexually interactive" and "sexually non-interactive".
	-- Revised slightly how actions are blocked by clothes.
	-- Added the "sexual combination validity" rulebook.
	-- Added the "default penile organ" and "default orificial organ" rulebooks.
	-- Added three new testing commands.
	-- Added a mouthfucking action.

	Version 6, December 25th, 2013
	-- Added phrase for lifting carrying requirements.
	-- Added support for showing body parts.
	-- Fixed bug related to kissing.

	Version 5, November 23rd, 2013
	-- Updated the custom body part names extension.
	-- Updated the clothing sets extension.
	-- Updated the public/private areas by Dudeman.
	-- Modified extension to be compatible with Advanced Layered Clothing by Another Wannabe.
	-- Added some useful phrases to find body parts.
	-- Reorganized contents so that they show up better in the phrase index.
	-- Replaced method to issue AIF library messages.
	-- Moved the sex tracking rules to the post-action bookkeeping rules.
	-- Deleted the Common Body Parts plugin and made it part of the core extension.
	-- Added hands/feet as optional body parts.
	-- Added support for the extension Object Response Tests by Juhana Leinonen.
	-- Provided support for face-fucking.

	Version 4, October 22nd, 2013
	-- Included a rulebook for obstructed sex acts, replacing the phrases that had been used.
	-- Fixed a bug that didn't display generic sex refusal messages correctly.
	-- Updated the Custom Body Parts Names plug-in.
	-- Fixed a bug which prevented characters from properly stripping other characters with clothing sets.
	-- Added disambiguation rules for examining.

	Version 3, October 20th, 2013
	-- Improved body part handling.
	-- Revised stripping rules.
	-- Revised action tracking rules.
	-- Revised understand rules.
	-- Added a phrase to change the player's gender.
	-- Revised "sex scenes" to "erotic".
	-- Erotic scenes will now set involved partners to "sex ready".
	-- Changed it so rules that effected "men" or "women" now effects "males" and "females" more generally.
	-- Moved public/private areas to plug-ins.
	--Added plugins

	Version 2, October 5th, 2012 --
	-- Some check rules were not properly blocking actions when a custom phrase was written for them. This should be fixed.
	-- Added some "Does the player mean" rules to better support multiple partners.
	-- Added a global variable "last partner specified", which is the last sexual partner of the player, for use with multiple partners.

	Version 1, October 3rd, 2012 --
	Initial public beta release.


Chapter: How to Write a Relatively Simple Sex Scene with Simpler AIF

Section: Startup

First we'll need to build our world...

	The concession stand is a room. The description is "This is a concession stand for a movie theatre. While there's a movie going on it's pretty dark in here, lit only by neon flourescent advertisements, so it occurs you this would be a really great place to have sex."

We could put all sorts of interesting and flavorful objects here, but of course this being an AIF game the most important stuff comes first: tits and pussy.

	Lilah is a woman in the concession stand.

In this case, making Lilah a person will just not do. A person is merely a genderless blank slate, useful only if we need a character we don't plan on effing. Women are bequeathed with breasts, ass and a pussy by default. Men have an ass and cock. If we use the Common Body Parts Plug-in, our character will be given some hair, a face, eyes, legs and a tummy. For our example we won't bother.
But what's this? Our poor player has nothing to do her with. Let's grant him the tools of his trade.

	The player is male. The player is heterosexual.
	
The player, depending on their initial gender, will be given a set of body parts named "your body part" i.e. your breasts, your ass, your pussy, your cock, and so on. The other thing we can do at this point is make the player homosexual, heterosexual or bisexual, with self-explanatory results.

Section: Sex

If we load up the game, all our advances will be met with a cripplingly generic "Now is almost certainly not the time." We can replace it by writing something more interesting for Lilah's generic sex refusal message.

	The generic sex refusal message of Lilah is "Lilah gives out a distasteful sigh. 'No way, Jos.'"

Alternatively, we can write something more complicated using an instead rule:

	Instead of trying sexual behavior in the presence of Lilah when Lilah is not sex ready:
		if the noun is Lilah or the noun is enclosed by Lilah:
			say "Lilah gives out a distasteful sigh. 'No way, Jos.'";
		else if the noun is enclosed by the player:
			say "Lilah's withering stare prevents you from pleasuring [the noun].";
		else:
			say "Lilah gives you a funny look, which stops you from doing what it was you were thinking of doing."

This is sufficient to not only stop any sexual advance, but to prevent the player from doing lewd sex acts in her presence. Note the "not sex ready". Only sex ready characters will accept sexual advances. If we didn't include this, Lilah would reject advances when we would otherwise want her to accept. As an aside, the player should never be set to not sex ready.

Of course, we've written a pretty boring sex game so far. There should be a way to seduce Lilah. A good AIF game has fascinating, deep characters and builds tension over time, with many little hints and teases leading up to the final consummation.

	After asking Lilah about "sex":
		say "'Do you want to have sex?' you ask Lilah.[paragraph break]Lilah shrugs. 'Ok.'";
		now Lilah is sex ready.

Making a character sex ready is sufficient to begin sex. However, it is nice to have sex occur within erotic scenes. The advantage with erotic scenes is that they help track what sex acts have been performed, allowing you to vary your prose and set up situations where the player needs to perform some sex act before they can move onto another. Sex tracking still works without erotic scenes... but it just works better with them, trust me.

	Sexy sexy time is an erotic scene. Sexy sexy time begins when Lilah is sex ready. Sexy sexy time ends when Lilah is not sex ready. The involved partners of sexy sexy time are {Lilah}.

The last line specifies who the "involved partners" are of the erotic scene. This list is basically for bookkeeping purposes and not strictly necessary if you aren't going to use the sex-tracking features. As a convenience, the involved partners are made sex ready when the scene begins and made not sex ready when the scene ends. There's no need to include the player, he/she's already assumed to be involved and their sex tracking will be reset. In fact adding the player to the involved partners list might be a bad idea as it will set him to not sex ready at the end of the scene.

Let's get to the good stuff.

	After fucking Lilah's pussy with your cock:
		if continuing the action:
			say "'Lilah, I'm gonna do you a little bit more, is that okay?' you ask.[paragraph break]'Go ahead,' she says boredly.[paragraph break]You pound her from the back.";
		else:
			say "'Do you mind if I fuck you a bit?' you ask her[paragraph break]'Yeah, sure,' she says, yawning.[paragraph break]You bend her carefully over the counter and begin doing her."

That was a very simple example.

We can get more complicated though. The action repeat count records how many times we successfully repeat a single action.

	After Lilah licking your cock:
		if the action repeat count is 1:
			say "Lilah begins to suck your cock.";
		else if the action repeat count is 2:
			say "She continues. You nod serenely as she does a hummer on you.";
		else if the action repeat count is 3:
			say "Whoa, looks like Old Faithful's about to burst! You wonder whether you should warn Lilah or not... very slowly.";
		else:
			say "Lilah does not look amused as she takes a load in her mouth. You smile at her guiltily.";
			now the action repeat count is 0.

After doing much of anything, the game will keep track of what you've done through a series of relations. These relations are: previously fuck, previously kiss, previously lick and previously rub, and track their respective actions.

	Instead of Lilah licking your cock when the player previously fucks Lilah's ass and Lilah is sex ready:
		say "'Duuuude,' she says, 'that thing has been in my [italic type]butt[roman type]!'"

PLEASE NOTE THE USE OF THE PRESENT TENSE in "previously fucks", which is true for all the sex tracking relations. If you use the past tense (i.e. previously fucked), it holds true even if the tracking was cleared. This could be useful if you want a character to refer to a past sex scene.

Sometimes it's more convenient for us to use an instead rule for a sex action, but we still don't want to treat it like a failure. For this purpose, we can use the "treat action as success" phrase, which, for recording purposes, will treat the action as a repeated action (it will not be recorded by a sex-tracking relation, however).

	Instead of rubbing Lilah's breasts:
		if continuing the action:
			say "'Doood your breasts are awesome,' you say, drooling as you fondle her.";
		else:
			say "Lilah's eyes narrow as you begin fondling her.";
		treat action as success.

A new feature of Version 11 is the "sex partner" variable. The sex partner is the person the actor is interacting with, something which you'll often want to use. 

	After fucking Lilah's breasts with your cock:
		say "[The sex partner] watches your boredly as you jam your cock between her tits."

Section: Layered Clothing

If you've been following the examples carefully, you'll notice the characters have to strip first before they can have sex. Clothing is controlled by the variables "worn layers" and "maximum worn layers", the maximum worn layers representing how many layers clothing a character could wear, and worn layers determines how many layers the character currently wears. Only the maximum worn layers need be set. At the start of the game, the worn layers of a character will be set to the maximum worn layers of a person.

	The maximum worn layers of Lilah is 2.

By default, all body parts are blocked unless the character is naked. The exception is rubbing, because of the mysterious powers fingers have to fondle through fabric. We don't often want such a clumsy handling of clothing. We can set our preferences using the clothing accessibility rules. Let's say Lilah wears a skirt and that she takes off her panties when she is down to worn layers 1.

	The skirt lifted is a truth state that varies.

	A clothing accessibility rule for Lilah when the worn layers of Lilah is 1:
		if the particular part is an ass or the particular part is a pussy:
			if the skirt lifted is false:
				say "You lift up her skirt to get access to her ass and pussy.";
				now the skirt lifted is true;
			rule succeeds.

In this rulebook, the "particular part" represents which part of the body we are trying to gain access to. If we wanted to restrict access to something, we'd have the rule fail instead. For your own rules, you can test if a body part is accessible by saying simply something like "if X is accessible".

Two useful adjectives here are "clothed" and "unclothed". "Clothed" is true when the person's worn layers is greater than 0. "Unclothed" is true when it's 0.

But the poor player doesn't know that she's taken her underwear off. Luckily, we can provide prose for our stripping rules. Every time a character strips, their worn layers goes down by 1. The dressing action is the inverse, and increases the worn layers.

	After Lilah stripping Lilah:
		if the worn layers of Lilah is 1:
			say "Lilah takes off her underwear underneath her skirt.";
		else:
			say "Lilah takes off the rest of her uniform."

And the player can help her out too.

	After the player stripping Lilah:
		if the worn layers of Lilah is 1:
			say "You take off her underwear beneath her skirt.";
		else:
			say "You rip off the rest of her uniform."

Worn layers are particularly useful for describing characters and body parts.

	Instead of examining Lilah:
		if the worn layers of Lilah is 2:
			say "She is in her work uniform... a colorful shirt with a pleated skirt.";
		else if the worn layers of Lilah is 1:
			say "She is generally in her uniform but her panties are about where her ankles are.";
		else:
			say "She is buck-o buck nekkid."

	The description of Lilah's breasts is "[if the worn layers of Lilah is greater than 0]She's wearing a shirt over her tits[else]Yep you can see them[end if]."

A final note. You will often want to write messages describing how a certain sex acts fail through clothing. Simpler AIF provides a special rulebook for this, the Obstructed Sex Act rules. This is a simple action based rulebook whose rules can be written like any other rulebook. If clothing figures a lot in your game you will be writing many, many of these rules.

	Obstructed sex act for Lilah licking your cock:
		say "Lilah painfully bumps her head against your erection, currently covered by your denim pants."

A notable exception for this is for fucking, because not only does the fucked body part need to be exposed, but also the body part to be fucked with. This is true when, for example, when one character is clothed and the partner is naked. You have to write rules that deal with this sensibly, like so.

	Obstructed sex act for fucking Lilah's pussy with your cock when your cock is not accessible:
		say "You try to jam your cock in Lilah's pussy, but to no avail... too much denim."
	Obstructed sex act for fucking Lilah's pussy with your cock when Lilah's pussy is not accessible:
		say "Lilah has one pair of panties too many to try that."

And that, there, is as simple as it can be put. In an actual fleshed out scene, a single rule will be as complicated as this entire example, and will represent about 1/20 of the effort that would be put in something with a merely decent amount of interactivity. That's also why AIF writing is immensely difficult, but also challenging and fun. But you're up for it. Right?

Chapter: Doing More Advanced Shit

Section: Optional Body Parts

As of version 5, Simpler AIF and all its sister extensions support a fairly extensive set of body parts, most of which are completely optional. They are already programmed in, you just need to drop in the relevant pieces of code.

To add hair, paste this in:

*:
	Some hair is a part of every man. Some hair is a part of every woman.
	A bodily construction rule:
		now your hair is part of the player.

To add faces, paste this in:

*:
	A face is a part of every man. A face is a part of every woman.
	A bodily construction rule:
		now your face is part of the player.

To add eyes, paste this in:

*:
	Some eyes are a part of every man. Some eyes are a part of every woman.
	A bodily construction rule:
		now your eyes are part of the player.

To add arms, paste this in:

*:
	Some arms are a part of every man. Some arms are a part of every woman.
	A bodily construction rule:
		now your arms are part of the player.

To add legs, paste this in:

*:
	Some legs are a part of every man. Some legs are a part of every woman.
	A bodily construction rule:
		now your legs are part of the player.

To add tummies, paste this in:

*:
	A tummy is a part of every man. A tummy is a part of every woman.
	A bodily construction rule:
		now your tummy is part of the player.

To add chests, paste this in:

*:
	A chest is a part of every man.
	A bodily construction rule when the player is male:
		now your chest is part of the player.

To add hands, paste this in:

*:
	Some hands are a part of every man. Some hands are a part of every woman.
	A bodily construction rule:
		now your hands are part of the player.

To add feet, paste this in:

*:
	Some feet are a part of every man. Some feet are a part of every woman.
	A bodily construction rule:
		now your feet are part of the player.

Most of these body parts can't be interacted with sexually. The ones that can include chests, faces, tummies and legs. Chests, tummies and legs can't be fucked but only rubbed and licked. Faces are a special case -- they are fuckable to allow the player to say "fuck mouth". Normally, this is considered a seperate action from the actor licking a body part (to allow the author to write prose for aggressive sex play). The "no face-fucking" option disables this behavior.

*:
	Use no face-fucking.
	
This makes it so any attempt to fuck a face redirects to the holder of the noun licking the cock or pussy of the actor.

Section: Sexuality and Wrong Sexuality

There is a new text property of people called the "wrong sexuality message", which is printed when the person is sex ready, but the sex act is refused because they aren't attracted to the person whose trying to bone them, or if they're asked to bone someone they aren't attracted to.

It goes a little like this:

	The wrong sexuality message of Bob is "'No way! I'm super straight! So straight, I don't even make turns when I drive. That's how straight I am. Yep.'"
	
You might want to replace the sexuality message for most people. Right now it's "That's not going to happen", which is purposefully non-descriptive.

The sexual orientation rules allow you to define exceptions under some circumstances.

	A sexual orientation rule for Bob licking your cock:
		say "'Hey, I may be super-straight, but that doesn't mean I can't suck a little dick occasionally right?'[paragraph break]'Whatever,' you say, unzipping your pants.";
		rule succeeds.

You can also use it to make more interesting messages for failure.

	A sexual orientation rule for fucking Bob's ass with your cock:
		say "'Whoa dude, I [italic type]definitely[roman type] don't go catcher...'";
		rule fails.

As would be expected, the sexual orientation rules aren't consulted if the actor is doing something to themselves. This is so, for example, someone doesn't get scared of their own cock or something.

Section: Willingness Rules

Version 15 adds a basic implementation of willingness beyond just sex ready and not sex ready. It can be expanded into something more interesting for your own needs, but by default it doesn't do anything. It is entirely optional and ignoring it won't effect your game at all. It simply allows for a finer degree of control over the flow of a sex scene.

The willingness rules fire just after the game checks sex readiness and sexual orientation. The intention is to cover circumstances where a character, being sex ready and of the proper sexual orientation, refuses a certain act, maybe because they aren't ready for it, or they think it's gross, or it's against their religion, or whatever.

An example:

	Willingness for fucking the bride's pussy with something:
		say "'No... please don't, that's for my future husband. Use my ass instead.'";
		unwilling.

"Unwilling" here tells I7 the action has failed. The reverse, "willing", means the character is up for it, and the action goes ahead.

	Willingness for fucking the bride's ass with the cucumber:
		say "'Well... as long as it isn't my pussy...'";
		willing.
		
A common feature in AIF is to have characters unwilling to do certain things until certain other actions have been completed. This is an easy way to do just that.

	Willingness for fucking the bride's pussy with your cock:
		unless the player previously fucks the bride's ass and the player previously licks the bride's pussy:
			say "'Hmm... I guess we've gone this far... I'm sure if my fiance never finds out...'";
			willing;
		else:
			say "[one of]'Mmm... that would be nice, but that's for the honeymoon...'[or]'How many times do I need to tell you? Not there!'[stopping]";
			unwilling.

The advantage of using this system over an "instead" rule is that the instead rule will sometimes fire at bad times, such as when a character is not sex ready. The willingness rules will only ever fire for a sex ready character. You can get very complicated, with all sorts of numbers that tick up and down to simulate who is ready for what. But this is just a simple framework for such systems.

Section: Customizing Default Messages

Version 12 removed Simpler AIF's message system, and Version 13 put it back in again (lol). This time, it is very much a combination of things you've seen before, utilizing tables and rulebooks to have very customizable input.

The simplest method to change the default messages is to go into the index, copy out the table, and replace each message with one of your own choosing.

	Table of Failure Responses (amended)
	rule name	message
	the can't kiss anything but people rule	"What?!? You want to kiss that! It has GERMS ALL OVER IT!"
	the can't kiss one's self rule	"What?!? Are you crazy? That's yourself! You don't know where that's been!"
	...etc...

The table above, however, would be quite odd applied to NPC actions. You can give each character in the game their own table.

*:
	Issue failure message rule when the actor is the player (this is the issue message of failure for the player's actions rule):
		if the reported reason is a rule name listed in the Table of My Failure Responses:
			say "[message entry][paragraph break]";
		else:
			continue the action.
	
	Table of My Failure Responses
	rule name	message
	the can't kiss anything but people rule	"What?!? You want to kiss that! It has GERMS ALL OVER IT!"
	the can't kiss one's self rule	"What?!? Are you crazy? That's yourself! You don't know where that's been!"

The "continue the action" point here is important. If the game fails to find the rule listed in the table, it will go to the default table, which means you only have to replace the things you want to replace.

However, you can use the issue failure message for very complex error messages.

	Issue failure message rule:
		if the reported reason is the can't kiss one's self rule:
			if the actor is the player:
				say "You succeed and wink out of existence.";
				end the story;
			else:
				say "They suddenly stop existing as they attempt to kiss themselves.";
				now the actor is off-stage.

Finally, you can use this system in your own rules.

	Check fucking something with a hot poker (this is the that hurts rule):
		issue failure message for the that hurts rule;
		rule succeeds.
	
	Table of Failure Responses (continued)
	rule name	message
	the that hurts rule	"That's far more painful than it's worth."


Section: How to Make New Body Parts

(As of version 5, feet are actually implemented as an optional body part, but for the purposes of this example, and because I'm too lazy to write something new, let's pretend they aren't)

Let's say we're in an era where you can make money from writing AIF and some foot fetishist has asked you to make a foot fetish game. The first thing we'll need is the feet. These need to be declared as a new kind of body parts.

	Some feet are kind of body part. The plural of feet is pairs of feet. Understand "feet/foot/toes/toe/soles/sole" as the feet. The feet are a part of every man. The feet are a part of every woman.
	
If we're ambivalent about the utility of putting feet on men we could simply delete "The feet are a part of every man" part. The one thing you should never do, however, is add a body part to every PERSON. That will also mean that you'll put feet on everything Inform 7 internally considers a person, and that could mean horses, tentacle monsters and Dick Cheneys end up getting feet where you didn't intend. Also, the compiler will slap on an extra pair of "your feet" to the player character, which is not what you want. For right now, our foot fetishist swings both ways. Or maybe she's a woman? You didn't consider that, did you? In any case, for any body part you make, you'll probably want to make one for the player too.

	your feet are feet. They are part of the player.

Alternatively, we can use the "Bodily Construction" rules to attach the feet to the player. The advantage of this is that, should the player ever have their body reconstructed (i.e. if the player were to change gender), the game knows where to restick the feet.

	A bodily construction rule:
		now your feet are part of the player.

As of Version 7, we no longer apply the adjective "sexable" to body parts but instead give it one of the following classifications: "orificial", "penile", "sexually interactive" and "sexually non-interactive".

An "orificial" body part is a body part that acts like a vagina and can be fucked with a penis. Examples: ass, breasts, face (the mouth specifically).

A "penile" body part is a body part that acts like a penis and can be fucked with a vagina. There is one example of a penile body part, the cock, although others are concievable (such as tentacles, tails, antennae or anything else you can think of).

A "sexually interactive" body part is something that can be licked and rubbed but not fucked or fucked with. Good examples include: chest, legs, tummies.

A "sexually non-interactive" body part is something that cannot be interacted with sexually at all. Examples include hair, eyes, hands and so on.

The feet are a complex example, because it is concievable we could use it to insert into people or have others put their dicks into it. We'll be making an action for it instead, so we'll make it sexually interactive -- the default for body parts.

*:
	The feet are sexually interactive.

Optionally, you can adapt the following extremely useful phrase. 

*:
	To decide which object is the/-- feet of (the individual - a person):
		if the individual incorporates some feet (called the item):
			decide on the item;
		decide on nothing.

Section: How to Make New Actions

Let's carry on with the foot fetish example. We'll make a footjob action. Make an action as normal.

	Footjobbing is an action applying to one touchable thing. Understand "give footjob to [something]" and "footjob [something]" as footjobbing.

It will save you much frustration to declare whatever action you have right now to be sexual behavior.

	Footjobbing is sexual behavior.

You'll need to provide a whole bunch of check rules to prevent absurd behavior. You'll also want redirect footjobbing a person to a body part. I won't bother listing those right now, but you can take a look at the extension to get a general idea. There are, however, a few rules that are generally important.

First is the one that redirects an oddly worded command used with the "fucking it with" action.

*:
	Redirect an actor fucking something with feet:
		if the feet are enclosed by a person (called K):
			try K footjobbing the noun.
			
Second is the one that redirects footjobbing a person to a body part.

*:
	Redirect an actor footjobbing a person:
		if the noun incorporates a cock (called K):
			try the actor footjobbing K;
		else if the noun incorporates a pussy (called J):
			try the actor footjobbing J.

Third is the one that checks to see if the various body parts are appropriately naked:

*:
	Check an actor footjobbing a noun:
		if the actor incorporates feet (called K):
			unless K are accessible:
				follow the obstructed sex act rules instead.

And, of course, we should provide the necessary obstructed sex act rules.

*:
	Obstructed sex act for an actor footjobbing something:
		say "[The actor] [are] going to give [the noun] serious abrasions if [regarding the actor][it] does it in [their] sneakers." instead.
				
Please note that, with all the rules above, you can't just copy-paste them, replace a few key words and expect them to work as intended. You have to put some thought into it, as each action will be different. The rules below, however, CAN be simply copy-pasted into your code and modified just a little. Consider them to be templates.
				
There are also a number of rules that are needed to incorporate the action into the existing willingness framework.

*:
	Check an actor footjobbing a body part enclosed by a person (called the bwner) (this is the wrong gender to footjob rule): 
		follow the sexual orientation rules;
		if rule fails:
			rule failed.
	
	Check an actor footjobbing a body part (this is the can't footjob unwilling people rule):
		if the holder of the noun is not sex ready and the holder of the noun is not the player:
			say the generic sex refusal message of the holder of the noun;
			stop the action.

This set of rules incorporate your new action into the last partner specified framework. The last partner specified is the person the player last did something with or asked to do something. It is used mostly internally for disambiguation reasons, but it is fairly important to include this or the action will behave oddly with the other actions.

*:
	Post-action bookkeeping an actor footjobbing a body part (this is the mark the person footjobbed as the last partner specified rule):
		unless the noun is a part of the actor:
			if the actor is the player:
				if the noun is enclosed by a person (called N):
					now the last partner specified is N;
			else if the noun is enclosed by the player:
				now the last partner specified is N.

	Does the player mean footjobbing a body part enclosed by (the last partner specified) (this is the assume that the player means to footjob the last person they interacted with rule):
		if the last partner specified is not visible, it is very unlikely;
		if the last partner specified is not a person, it is very unlikely;
		it is very likely.

Optionally, you can adapt some of the disambiguation rules.

*:	
	Does the player mean footjobbing a body part enclosed by the player (this is the assume the player doesn't mean to footjob with themselves rule): it is unlikely.
	Does the player mean footjobbing body part enclosed by a male person when the player doesn't like men (this is the assume the player doesn't mean to footjob with men when they don't like men rule):
		it is very unlikely.
	Does the player mean footjobbing a body part enclosed by a female person when the player doesn't like women (this is the assume the player doesn't mean to footjob with women when they don't like women rule):
		it is very unlikely.

If (AND ONLY IF) you are using Jon Ingold's Disambiguation Control extension, you can use these instead. It's highly recommended you use these as your disambiguation will improve dramatically.

*:
	Should the game suggest footjobbing a body part incorporated by a male person when the player is androphilic (this is the assume the player wants to footjob men when the player is attracted to men rule): it is a good suggestion.
	Should the game suggest footjobbing a body part incorporated by a female person when the player is gynephilic (this is the assume the player wants to footjob women when the player is attracted to women rule): it is a good suggestion.
	Should the game suggest footjobbing a body part incorporated by a last partner specified (this is the assume the player wants to footjob the last partner specified rule): it is an excellent suggestion.
	Should the game suggest asking a person to try footjobbing a body part incorporated by the person asked (this is the assume the player wants to ask people to footjob themselves rule): it is a bad suggestion.
	Should the game suggest asking a person to try footjobbing a body part incorporated by the player (this is the assume the player wants to ask people to footjob the player rule): it is a good suggestion.

Finally, you should allow NPCs to use your action. By default they will refuse.

*:
	Persuasion rule for asking people to try footjobbing: persuasion succeeds.
	Unsuccessful attempt by someone footjobbing: stop the action.

The last rule suppresses a message that is displayed when the NPC fails the action. In this case, it's redundant since the action itself will provide feedback to the player.

At this point, you can provide a report rule call it a day. However, if you want to use the same sex tracking systems as the other actions, you'll have to adapt the following code:

*:
	Footjob-tracking relates various people to various body parts.
	The verb to previously footjob (he previously footjobs, they previously footjob, he previously footjobbed, it is previously footjobbed, he is previously footjobbing) implies the footjob-tracking relation.

	Post-action bookkeeping an actor footjobbing (this is the track footjobbing rule):
		now the actor previously footjobs the noun.
	
	When a erotic scene (called K) begins:
		repeat with P running through the involved partners of K:
			now P previously footjobs nothing;
		now the player previously footjobs nothing.
		
Version 15 adds a willingness rulebook. While it doesn't do anything by default, you can add any particular action you want to it by adding this code.

*:
	Last check an actor footjobbing something (this is the check footjobbing willingness rule):
		follow the willingness rules;
		if the rule failed:
			rule fails.

Section: Sex Toys

Support for sex toys was added in Version 7.

Sex toys are a "kind" of object that can be fucked or fucked with. Now, while you can define a normal object as "penile" and "orificial", thus making it fuckable, this is not recommended. SAIF handles sex toys differently from other things and it is better to, say, define a table leg as a sex toy rather than try to replicate the handling of table legs for sex toys.

	The black dildo is a sex toy.
	The black strap-on is a strap-on.

There are four different kinds of sex toys: "sex toys", "vibrators", "strap-ons" and "vibrating strap-ons". Strap-ons are identical to sex toys except they can be worn. Sex toys are defined as "orificial" and "penile". A penile sex toy is like a dildo and acts pretty much like you'd expect. An orificial sex toy is more like a flesh light or something else you put your dick into. A strap-on can also be orificial, which doesn't make a whole lot of sense but is allowed by default. Vibrators are identical to sex toys except they can be switched on or off, and vibrating strap-ons are strap-ons that can be turned on or off. Men, having both penile and orificial body parts, will never implicitly use a sex toy unless the player specifically types it out. A woman will implicitly use a sex toy when asked to fuck an orificial thing and has a sex toy on hand, otherwise they will use their pussy.

SAIF will always try to convert a fucking it with action so that the second noun is the sex toy and the first noun is a body part. For example, if the player types "Jane, fuck dildo with pussy", the game will try and turn that into Jane fucking Jane's pussy with the dildo. If both the first and second noun are sex toys, the action will be blocked. The game will also block attempts to fuck an object carried by someone else.

Other than that, a fucking action written with a sex toy is identical to that of a normal fucking action.

	After Denise fucking Jane's pussy with the black strap-on:
		say "Denise thrusts the strap-on into Jane."

Some additional notes about strap-ons: Characters who have cocks are prevented from wearing strap-ons, characters cannot dress while wearing a strap-on and strap-ons can only be worn if the character is naked.

Section: Switching a Character's Gender

For the player, Simpler AIF provides a simple phrase to switch the gender of the player.

	After entering the Gender Bender:
		switch gender.

This will instantly switch the player to the opposite gender, remove all of the body parts, and use the Bodily Construction rulebook to recreate the body. It even alters the sexuality so that the PC is still attracted to the same gender as before. If you want a heterosexual, woman-loving male PC to turn into a heterosexual, man-loving female PC, you have to do that manually.

For NPCs, this gets a little more complicated, since by default NPCs aren't provided body parts of the opposite gender and are already assigned as "men" or "women", an unalterable state of affairs. Perhaps the simplest way to do this (and this extension is all about simplicity!) is to make two characters, one of each gender, who are only notionally the same person, and switch them out as needed. The alternative is to make a gender-switching kind of person, but that is beyond the scope of this documentation.

Section: Making Odd Genders and Monsters

Making odd genders couldn't be simpler, as long as you aren't planning on giving them multiple dicks or six sets of breasts, which could get a little complicated.

	A futa is a kind of person. They are female. A pussy is a part of every futa. A cock is a part of every futa. An ass is a part of every futa. Some breasts are a part of every futa.

The "male", "female" and "neuter" adjectives represent, notionally, whether our new gender is masculine or feminine, even if it isn't really any of them. This affects who is attracted to the characters and what pronouns we will use to refer to them. Now, complications arise if we want don't want to make a character male or female but shmefale. I do not recommend attempting this, as this would involve making entirely different sexualities and going into the guts of the engine and changing the pronouns. There are several extensions useful for this, but it is not in the scope of this extension.

One of the strengths of the clothing accessibility system is that, if you want to have someone's cock hanging from their forehead instead of their groin, you can do that.

	Clothing accessibility for the overly literal dick head:
		if the particular part is a cock:
			if the overly literal dick head is not wearing a hat:
				rule succeeds;
			else:
				rule fails.

An additional note, if you want the player to be some sort of weird cock lady with tentacles or something, the best way to accomplish this is by unlisting all of the default bodily construction rules and simply writing your own. Alternatively, you could make, say, a futa character than declare, "now the player is the weird cock lady", but that's going to arise in complications and frankly I do not advise that unless you are experienced in I7.

As of version 7, you can define how SAIF picks default body parts, which is useful for non-standard anatomies. You can look "How the Fucking Action Works & Customizing its Behavior" section of this documentation for details.

Section: Making Background Characters

Often, you will not want to make full-on characters. The convience store clerk that sells the player candy bars doesn't need a full set of body parts. Generally, if they won't be involved in a sex scene, it isn't necessary to.

To make such a character, all you need to do is to define them as a person instead of a man or woman.

	The clerk is a person. The clerk is male.

This makes a person who has no body parts, which may or may not be perfectly suitable for his role in the game.

Section: The Bookkeeping Rulebooks

Novices, skip this section.

...Are they gone? Good.

Generally, AIF authors are more fond than most of tracking stuff, which mean they will often make rules expressly to bookkeep this sort of thing. Often, these sorts of rules are in the Before rules and After rules, which isn't appropriate since what they really are are glorified "check" and "carry out" rules. But because I7 doesn't support generalized check and carry out rules, they are forced elsewhere. Usually, it's alright, but often when we have a bunch of extensions it can get a little crowded. Now, such rules can be moved into the "post-action bookkeeping rulebook" (which triggers after the "after" rulebook and hence the action must be successful before it can be consulted), the "mid-action bookkeeping rulebook" (which triggers before the carry-out rules) and "pre-action bookkeeping rulebook" (which triggers just before the "before" rulebook and therefore will ALWAYS be consulted, except in version 5 where the redirect rules now have a chance to intervene). They exist purely to avoid cluttering up other rulebooks with various bookkeeping rules, possibly causing complications. Feel free to drop new and old rules in there.

Importantly, the "treat action as success" phrase consults the mid-action bookkeeping rules and the post-action bookkeeping rules, meaning that, even if an action were to fail, it would still activate the sex-tracking system and so forth.

Section: Changes to the After Rule

Simpler AIF does something theoretically a little dangerous. It has made a minor change to the after stage rule, to ensure that the post-action bookkeeping rule is always consulted.

What sort of impact will this have on your game? Probably nothing. I don't know of any other extensions that replace the after stage rule. But it is something to bear in mind.

Section: Lifting Carrying Requirements & Flashing Body Parts
	
Because of the way I7 is written, the game assumes that if you try and show someone something, you must be holding it in the literal sense. So, when you, say, show your cock to someone, the game will try and make you grab your cock and proffer it out like some grisly dismembered trophy. Simpler AIF lifts this restriction and allows for the flashing of body parts to other characters in a way that is sensible. You cannot, on the other hand, show someone else's body parts to someone else... the carrying requirement rules still apply. So now you can write things like this:

	After showing your cock to the nun: say "The nun squeals in shock!"

Coincidentally, this provides an elegant solution to the problem of needing to pick things up before eating them, allowing people to finally eat things even fixed in place. To do this, simply write a rule like this:

*:
	Pre-action bookkeeping rule for eating something fixed in place:
		toggle off carrying requirements.
		
The "toggle off carrying requirements" phrase will only temporarily lift the carrying requirement rules, so it is quite handy. It can be used in any situation where literally holding something is not appropriate.

Section: Debugging

As of Version 7, there are some debugging commands that might be useful.

	fuck-test Dan on Jill
	
This action goes through every combination of body parts between the two characters and attempts to fuck with them, even odd ones like FUCK JILL'S HAIR WITH DAN'S FEET.

	lick-test Dan on Jill

This action causes Dan to lick every body part of Jill's.

	rub-test Dan on Jill.

Ditto, except with rubbing.

Finally, SAIF interacts with Juhana Leinonen's Object Response Tests extension. This adds some of SAIF's actions to the object response tests... read the documentation of that extension for more details.

Chapter: Reference

Section: How the Fucking Action Works & Customizing its Behavior

Version 7 represents a complete rewrite of the fucking action, meaning the "fucking" action redirects almost always to the "fucking it with" action. This will be a minor nuisance if you weren't deep into the internals of Simpler AIF, meaning you'd have to rework a lot of rules and rewrite a lot of your library messages. However, if you were one of those people that plunged into SAIF, this will be a great boon to you, as it is much simpler to do complex stuff for the following reasons:

1) Previously, fucking it with and fucking were two different actions with seperate handling that pretty much did exactly the same thing. Now, they work through a single action, making things a lot more simple internally and ensuring things behave more consistently.

2) Previously, it was difficult to refer to the thing that was being fucked with. For example, if Bob is fucking Jane's pussy and we wanted to refer to Bob's cock, we'd have to guess. Now, Bob's cock is the second noun making it simple to refer to it.

3) Previously, certain actions like tribadism and frotting were impossible because of the way the fucking action was handled. Now there are much wider variety of actions possible.

How it works: the success of the fucking action largely depends on whether something is orificial or penile. A penile thing can fuck something orificial and an orificial thing can fuck something penile, but orificial and penile things can't fuck each other... EXCEPT if we define an exception for it.

The fucking it with action refer to a rulebook verbosely called the "sexual combination validity rules". These define the acceptable combinations of actions. Such a rule looks a little like this:

	Sexual combination validity for an actor fucking a pussy with a pussy (this is the permit tribbing rule): combination valid.
	
This is the rule that permits tribbing to occur (something allowed by default now). However, we can define other combinations as valid.

	Sexual combination validity for an actor fucking an ass with some breasts (this is the strange sex rule): combination valid.

Conversely, we can define a combination normally valid to be invalid.

	Sexual combination validity for an actor fucking some breasts with a cock (this is the no tit-fucking rule): say "In this world, such a sex act is virtually unheard of."; combination invalid.

Keep in mind this is not the best way to block sex actions that you want the player to attempt later. This is a sledge-hammer approach and designed to handle things that should NEVER be possible.

No, this isn't a list of the word's most awesome supreme court cases, but the combinations permitted by default in SAIF (the first thing is the noun, the second thing is the second noun):

	cock v cock
	ass v cock
	breasts v cock
	pussy v cock
	face v cock
	pussy v pussy
	cock v pussy
	face v pussy
	cock v ass
	cock v breasts
	
Next, we'll talk about how the game converts a fucking action to a fucking it with action. In this case, SAIF handles three cases. The first two are straightforward.

	FUCKING SOMETHING ORIFICIAL
	
In this case, the game consults the "default penile organ" rulebook for the actor in search of a second noun. The default penile organ rules are a person-based rulebook producing an object. By default, the game selects an object by the following priority: 1) the last fucktool used, if the actor is holding it and it's penile. 2) a cock of the actor. 3) any other penile organ the actor has. 4) a penile sex toy held by the actor. 5) if the actor is a woman, her pussy. 5) finally, the game gives up and produces nothing. Men will tend to default on a cock and women will default on their pussy.

You can customize the behavior of this rulebook by writing your own rules.

	Default penile organ for the tentacle monster:
		rule succeeds with result horrible tentacles.

	FUCKING SOMETHING PENILE
	
In this case, the game consults the "default orificial organ" rulebook, which works similarly to the default penile organ rules. Again, it consults things in the following order. 1) the last fucktool used, if the actor is holding it and it's orificial. 2) a pussy of the actor or the ass of the actor. 3) any other orificial organ the actor has. 4) an orificial sex toy held by the actor. 5) if the actor is a man, his cock. 5) finally, the game gives up and produces nothing.

Again, this behavior can be customized.

	Default orificial organ for the lamprey (this is the extremely unfortunate rule):
		rule succeeds with result horrible maw.

	FUCKING A PERSON
	
In this case, SAIF attempts to surmise the player's intentions by looking at the gender of the actor and the noun.

	MALE ACTOR, FEMALE NOUN: pussy with cock.
	FEMALE ACTOR, MALE NOUN: cock with pussy.
	FEMALE ACTOR, FEMALE NOUN: pussy with pussy.
	MALE ACTOR, MALE NOUN: ass with cock.

Section: New Kinds Reference

	ARMS: sexually non-interactive, both genders, optional
	ASS: body part; orificial, both genders, not optional
	BODY PART: thing; usually sexually interactive
	BREASTS: body part; orificial, both genders, not optional
	COCK: body part; penile, males only, not optional
	CHEST: body part; sexually interactive, both genders, optional
	EYES: body part, sexually non-interactive, both genders, optional
	FACE: body part; orificial, both genders, optional
	FEET: body part, sexually non-interactive, both genders, optional
	HANDS: body part, sexually non-interactive, both genders, optional
	HAIR: body part, sexually non-interactive, both genders, optional
	LEGS: body part; sexually non-interactive; both genders; optional
	PUSSY: body part; orificial, females only, not optional
	SEX TOY: thing, usually penile
	STRAP-ON: sex toy, wearable, usually penile
	TUMMY: body part; sexually interactive, both genders, optional
	VIBRATOR: sex toy, usually penile, can be switched on or off.
	VIBRATING STRAP-ON: strap-on, usually penile, can be switched on or off

Section: Variables Reference

	ACTING ACTION: a stored action used internally in the sex memory framework.
	ACTION MEMORY: a truth state that toggles the action memory system.
	ACTION REPEAT COUNT: a number defined as the number of times an action has been repeated. It resets every time a new action has been successfully performed.
	GENERIC SEX REFUSAL MESSAGE: a text property of people displayed when an NPC refuses to perform an action.
	LAST ACTION: a stored action used internally in the sex memory framework.
	LAST FUCKTOOL: an object defined as the second noun in a successful fucking it with action. SAIF will prefer the last fucktool in ambiguous cases.
	LAST PARTNER SPECIFIED: a person defined as the last person the player interacted with sexually. Used for disambiguation purposes.
	MAXIMUM WORN LAYERS: a numerical property of people defined as the number of layers that could be worn by an actor.
	PARTICULAR PART: an object for use in testing clothing accessibility, defined as the object tested.
	PREVIOUS ACTION: a stored action defined as the last successful action.
	REPORTED RULE: a rule which was the last rule that failed.
	WORN LAYERS: a numerical property of people defined as the number of layers currently worn by an actor.
	WRONG SEXUALITY MESSAGE: a text property thrown by a person when asked to do something with someone of an incompatible sexuality.

Section: Action Reference

	ASSFUCKING SOMETHING: redirects to fucking a person's ass.
	DRESSING: a simple action that increments the worn layers of a person.
	FROTTING SOMETHING: redirects to fucking a cock with a cock or a pussy with a pussy, depending on the gender of the actor.
	FUCKING SOMETHING: redirects to fucking something with something, taking an educated guess for the second noun.
	FUCKING SOMETHING WITH SOMETHING: a large, complex action that encompasses a variety of sex acts. See "How the Fucking Action Works" above.
	LICKING SOMETHING: an action that can be performed on any sexually interactive body part, but is blocked by clothing. Characters cannot lick themselves (except women can lick their own breasts).
	MOUTHFUCKING SOMETHING: redirect to fucking a person's face or, if they don't have a face, to the person licking the actor's penile organ.
	RUBBING SOMETHING: an action that can be preformed on any sexually interactive body part, and is not blocked by clothing. Characters can rub any part of themseves.
	STRIPPING SOMETHING: an action which takes away a layer of clothing. If used by itself without a noun, it assumes the actor wants to strip themselves.
	TITFUCKING SOMETHING: redirects to fucking a person's breasts.

Section: Rulebook Reference

	BODILY CONSTRUCTION RULES (action based): a rulebook, when invoked, builds the body of the player. Used at the beginning of the game and when the "switch gender" phrase is invoked.
	CLOTHING ACCESSIBILITY RULES (person based): a rulebook that tests the "particular part" variable to see if it is covered by clothing.
	DEFAULT ORIFICIAL ORGAN RULES (person based): a rulebook that guesses which orificial organ will be used for a sex act.
	DEFAULT PENILE ORGAN RULES (person based): a rulebook that guesses which penile organ will be used for a sex act.
	ISSUE FAILURE MESSAGE RULES (action based): a rulebook that fires whenever a rule from this extension fails.
	MID-ACTION BOOKKEEPING RULES (action based): a rulebook that fires just before the CARRY OUT rules.
	OBSTRUCTED SEX ACT RULES (action based, default success): a rulebook that prints some proses when a piece of clothing blocks a sex act.
	POST-ACTION BOOKKEEPING RULES (action based): a rulebook that is invoked after the AFTER rules. It does things like record the previous action. We can manually invoke it by using the "treat action as success" phrase.
	PRE-ACTION BOOKKEEPING RULES (action based): a rulebook that is invoked before the BEFORE rules, when we are not sure the action is successful. It does a few bookkeeping tasks necessary to record the previous action.
	REDIRECT RULES (action based, default failure): a rulebook consulted before the BEFORE rules, used to convert actions to another action.
	SEXUAL COMBINATION VALIDITY RULES (action based): a rulebook, invoked during a CHECK FUCKING IT WITH rule, to determine whether a combination is valid or not. If the rule succeeds, the combination is valid. If the rule fails, the combination is invalid. The last rule of the rulebook defaults to failure.
	SEXUAL ORIENTATION RULES (action based): a rulebook that senses if the actor and the sex partner are sexually compatible. Throws up the Wrong Sexuality Message if the actions fails.
	WILLINGNESS RULES (action based): a rulebook that is empty by default, but determines whether an otherwise sex ready actor is willing to perform a specific act. Defaults to failure.

Section: Adjective Reference

	ANDROPHLIC: defined as a character who will have sex with men.
	BISEXUAL, HETEROSEXUAL, HOMOSEXUAL: assignable, defines the sexuality of a person
	CLOTHED: defined as a person whose worn layers are not 0, hence, has clothes.
	EROTIC: assignable, defined as a scene which will have sex in it.
	FUCKABLE: defined as a thing which is either orificial or penile.
	GYNEPHILIC: defined as a character who will have sex with women.
	NPC: defined as a person who is not the player.
	ORIFICIAL, PENILE, SEXUALLY INTERACTIVE, SEXUALLY NON-INTERACTIVE: assignable, defines whether it can be fucked like a cock, a vagina, can only be licked and rubbed, or can't be interacted with at all, respectively.
	SEX READY: assignable, defines a character who will accept requests to have sex.
	SEXABLE: defined as an object that can be interacted with sexually.
	UNCLOTHED: defined as a person whose worn layers are 0.

Section: Phrase Reference

	if ANY SEXUAL ACTIVITY OCCURRED BETWEEN (PERSON) WITH (PERSON)...: returns true if there was any sexual activity between the first person and second person.
	CAPTURE THE ACTION: a deprecated phrase that is only used internally.
	(KIND OF BODY PART) of (A PERSON)... object: returns a body part of the kind specified incorporated by the person, or nothing if nothing could be found.
	if (PERSON) DOESN'T LIKE MEN...: returns true if the person is a heterosexual male or homosexual female.
	if (PERSON) DOESN'T LIKE WOMEN...: returns true if the person is a heterosexual female or homosexual male.
	if (PERSON) HAS FUCKED ANY PART OF (PERSON)...: returns true if the "previously fucks" relation holds between the first person and any of the second person's body parts.
	if (PERSON) HAS LICKED ANY PART OF (PERSON)...: returns true if the "previously licks" relation holds between the first person and any of the second person's body parts.
	if (PERSON) HAS RUBBED ANY PART OF (PERSON)...: returns true if the "previously rubs" relation holds between the first person and any of the second person's body parts.
	if (PERSON) IS ATTRACTED TO (PERSON)...: returns true when the character is sexually compatible with the second character.
	if (PERSON) IS NOT ATTRACTED TO (PERSON)...: returns true when the character is not sexually compatible with the second character.
	say DISPREFERRED GENDER OF (A PERSON)...: says either "men" or "women", depending on what the person doesn't like. Try not to use for bisexual characters.
	SEX PARTNER...object: returns the person the current actor is playing around with... including themselves.
	SWITCH GENDER: causes the player to instantly switch genders.
	if (A THING) IS ACCESSIBLE...: returns true if the thing is not covered by clothing.
	if (A THING) IS NOT ACCESSIBLE...: returns true if the thing is covered by clothing.
	TOGGLE OFF CARRYING REQUIREMENTS: only usable if you are using Ignored Rules by Ron Newcomb. Allows you to ignore the carrying requirements for that action only.
	TREAT ACTION AS SUCCESS: causes SAIF to immediately consult the POST-ACTION BOOKKEEPING RULES.

Section: Relations Reference

	FUCK-TRACKING: tracks who fucked what.
	LICK-TRACKING: tracks who licked what.
	RUB-TRACKING: tracks who rubbed what.
	KISS-TRACKING: tracks who kissed what.

Chapter: Plug-ins

To use these plug-ins, simply read the instructions, then press the square next to the code, and the game will automatically insert the plug in for you. The alternative form of installation is to go into the extension, find where the plug-in has been commented out, and the remove the comments. That should help your code look cleaner.


Section: Consolidated Sex Actions Plug-in

This plug-in is written to make writing AIF a little more tolerable by consolidating very similar actions together. Because I am an equal-opportunity pervert, there are two versions of this plug-in, "penile-focused" and "orifice-focused".  The first ensures that the character fucking with a penile object is always the actor (so that "FUCK PENIS WITH VAGINA" becomes "FUCK VAGINA WITH PENIS"), and the other does just the opposite (so that "FUCK VAGINA WITH PENIS" becomes "FUCK PENIS WITH VAGINA"). This plug-in doesn't do anything in cases where both objects are of the same type. Including both versions is probably disastrous.

This is the penis-focused version.

*:
	Redirect an actor fucking something penile with something orificial (this is the penile-focused fucking rule):
		if the noun is enclosed by a person (called the individual):
			try the individual fucking the second noun with the noun;
		else:
			continue the action.

And here is the orifice-focused version.

*:
	Redirect an actor fucking something orificial with something penile (this is the orifice-focused fucking rule):
		if the noun is enclosed by a person (called the individual):
			try the individual fucking the second noun with the noun;
		else:
			continue the action.

Section: Default Clothing Behavior Plug-in

This adds some default clothing behavior to all players if no clothing accessibility rules are written for a person. Basically, the game assumes that every character is wearing a shirt and pants at worn layers 2, and underwear (bra and panties for women, underwear for men) at worn layers 1. Bear in mind you'll have to manually set the maximum worn layers of each person to 2 if you plan on using these default rules. Requires the Common Body Parts Plug-in.

*:	
	Last clothing accessibility rule for a person (called K) when the worn layers of K are 2 (this is the shirt and pants rule):
		if the particular part are breasts or the particular part is an ass or the particular part is a pussy or the particular part is a cock or the particular part are legs or the particular part is a tummy or the particular part is a chest:
			rule fails;
		rule succeeds.
	Last clothing accessibility rule for a person (called K) when the worn layers of K are 1 (this is the down to underwear rule):
		if the particular part are breasts or the particular part is an ass or the particular part is a pussy or the particular part is a cock:
			rule fails;
		rule succeeds.

Section: Public/Private Areas by Dudeman
		
This plug-in was originally part of the core Simpler AIF extension, but the functionality was too specific to be useful to all AIF authors, and I generally found it got in the way of what I was intending. This plug-in defines an area as either public or private -- sex can't be performed while in view of a non-sex ready person, and you cannot go into public rooms naked.

*:
	A room is either private or public. A room is usually public.

	A person has a text called the too public message. The too public message of a person is usually "It [if the story tense is present tense]is[else]was[end if] a little too public to be trying that.".

	to decide whether in public: if a not sex ready person is visible, decide yes; if the player is enclosed by a public room, decide yes; if the player is in a private room, decide no.

	Check an actor going to a room (called the place) while the actor is unclothed (this is the can't walk into a public area indecent rule):
		say "[The actor] [shouldn't go] into public dressed like that." (A) instead.

	Check an actor rubbing a body part enclosed by a person (called the bwner) while the location of the actor is public (this is the can't rub someone in public rule):
		say "[Too public message of the actor][paragraph break]" (A) instead.

	Check an actor rubbing a sex toy while the location of the actor is public (this is the can't rub sex toys in public rule):
		say "[Too public message of the actor][paragraph break]" (A) instead.

	Check an actor licking a body part enclosed by a person (called the bwner) while the location of the actor is public (this is the can't lick someone in public rule):
		say "[Too public message of the actor][paragraph break]" (A) instead.

	Check an actor licking a sex toy while the location of the actor is public (this is the can't lick sex toys in public rule):
		say "[Too public message of the actor][paragraph break]" (A) instead.

	Check an actor fucking a body part enclosed by a person (called the bwner) while the location of the actor is public (this is the can't fuck someone in public rule):
		say "[Too public message of the actor][paragraph break]" (A) instead.

	Check an actor fucking a body part enclosed by a person (called the bwner) with something while the location of the actor is public (this is the can't fuck someone with something in public rule):
		say "[Too public message of the actor][paragraph break]" (A) instead.

	Check an actor stripping while the location of the actor is public (this is the can't strip in public rule):
		say "[Too public message of the actor][paragraph break]" (A) instead.

Section: Custom Body Parts Names Plug-in

This plug-in allows authors to define their own names for default body parts. For some authors, "pussy" is a little too obscene... for others, not obscene enough. A text variable is provided for each body part in the format Default (Body Part) Name, so now you can write Now the Default Pussy Name is "vagina". As a bonus, the printed body part name of the last partner specified will be "her body part" or "his body part". Remember to provide Understand rules if you name them something particularly exotic. Please note this only effects how the name is printed. To change the INTERNAL name of a body part, you have to go into the extension and replace, for example, "Some breasts are a part of every woman." with "Some breasts are a part of every woman (called its tits).", which will rename everything Anna's tits, Delilah's tits, etc.

Originally, this plugin was divided into two parts, one for core body parts and the other for the optional ones. Since the optional body parts have been made as part of the core extension, both have been consolidated into one plugin.

The code for capitalizing is borrowed from Shadowwolf. Thanks Shadowwolf!

*:
	Include (-

	[ CAPITALIZING_MODE ; 
		return caps_mode;
	];

	-) after "Printing.i6t"

	To decide whether capitalizing: (- (CAPITALIZING_MODE() ) -).

	To say the/-- preamble for (K - a person):
		unless capitalizing:
			if K is the last partner specified:
				say "[regarding K][their]";
			else if K is the player:
				say "[our]";
			else:
				say "[the k]'s";
		else:
			if K is the last partner specified:
				say "[regarding K][Their]";
			else if K is the player:
				say "[Our]";
			else:
				say "[The K]'s".

	The default pussy name is a text variable. The default pussy name is "pussy".
	The default breasts name is a text variable. The default breasts name are "breasts".
	The default ass name is a text variable. The default ass name is "ass".
	The default cock name is a text variable. The default cock name is "cock".

	Rule for printing the name of a pussy (called J):
		if J is enclosed by a person (called K):
			say "[preamble for K] [default pussy name]".

	Rule for printing the name of breasts (called J):
		if J is enclosed by a person (called K):
			say "[preamble for K] [default breasts name]".

	Rule for printing the name of ass (called J):
		if J is enclosed by a person (called K):
			say "[preamble for K] [default ass name]".

	Rule for printing the name of cock (called J):
		if J is enclosed by a person (called K):
			say "[preamble for K] [default cock name]".

	The default hair name is a text variable. The default hair name is "hair".
	The default face name is a text variable. The default face name is "face".
	The default eyes name is a text variable. The default eyes name is "eyes".
	The default legs name is a text variable. The default legs name is "legs".
	The default tummy name is a text variable. The default tummy name is "tummy".
	The default chest name is a text variable. The default chest name is "chest".
	The default arms name is a text variable. The default arms name is "arms".

	Rule for printing the name of hair (called J):
		if J is enclosed by a person (called K):
			say "[preamble for K] [default hair name]".

	Rule for printing the name of face (called J):
		if J is enclosed by a person (called K):
			say "[preamble for K] [default face name]".

	Rule for printing the name of eyes (called J):
		if J is enclosed by a person (called K):
			say "[preamble for K] [default eyes name]".

	Rule for printing the name of legs (called J):
		if J is enclosed by a person (called K):
			say "[preamble for K] [default legs name]".

	Rule for printing the name of tummy (called J):
		if J is enclosed by a person (called K):
			say "[preamble for K] [default tummy name]".

	Rule for printing the name of chest (called J):
		if J is enclosed by a person (called K):
			say "[preamble for K] [default chest name]".

	Rule for printing the name of arms (called J):
		if J is enclosed by a person (called K):
			say "[preamble for K] [default arms name]".

	The default hands name is a text variable. The default hands name is "hands".
	The default feet name is a text variable. The default feet name is "feet".

	Rule for printing the name of hands (called J):
		if J is enclosed by a person (called K):
			say "[preamble for K] [default hands name]".

	Rule for printing the name of feet (called J):
		if J is enclosed by a person (called K):
			say "[preamble for K] [default feet name]".

Unfortunately, issues with capitalization persist with this plug-in, despite my best efforts. Probably the best way to resolve it is with the Output Filtering extension by Ron Newcomb, which unfortunately is not yet updated to the most recent version of I7. You might have to make do with lower case letters, or else avoid using body parts at the beginning of sentences. Another possible solution:

	say "[Jane's ass] looks swell." in sentence casing.

This should capitalize the first letter of each sentence in the final output.
						
Section: Clothing Sets Plug-in

This plug-in is perhaps the most complicated and fiddly, and extends Simpler AIF's default clothing system, allowing you to change "clothing sets", which represents an entire ensemble of clothing (i.e. a suit, a uniform, Sunday clothes, etc). It is also not tested very extensively, so expect perhaps an error or two.

A clothing set is a thing that can be worn.

	The nice suit is a clothing set. The player is wearing the nice suit. The maximum worn layers are 2. The description is "A recently pressed suit, you just got it from the dry cleaners."

Like people, a clothing set has worn layers and maximum worn layers. When a clothing set is worn, the old one (if any) is discared, and the maximum worn layers of the clothing set becomes the maximum worn layers of the actor. In addition, the worn layers of the clothing set rises and falls with the wearer's, so testing the worn layers of the actor and the worn layers of the clothing set should result in the exact same thing. I repeat:

	worn layers of a clothing set = worn layers of the person wearing the clothing set

The clothing set worn by a person is called its "outfit", and a player can wear one outfit at a time. You should never say "now the outfit of Yvonne is the sexy lingerie" and instead use the phrase "have Yvonne change into the sexy lingerie".

Clothing sets can be taken off in two ways. The first way is to strip until the worn layers are 0. The second way is for a character to wear a different clothing set, in which case they'll take off their old one. In either case, for the player's convenience, clothing sets will be dropped if worn by NPCs (for easy manipulation by the PC) and moved to the inventory if worn by PCs. Two variables are identified. The "previously worn outfit" of a person is the outfit they had taken off last. This is for use in action redirection, disambiguation and missing noun rules. The "outfit taken off" is a wearing action variable which identifies what the PC had to take off before wearing the new clothing set, and is intended for After rulebooks.

Characters wearing clothing sets will instead use the Outfit Accessibility rules instead of the standard Clothing Accessibility rules EXCEPT when their worn layers are 0. The Outfit Accessibility rules are a clothing set based rulebook and are identical in function to the Clothing Accessibility rulebook.

Outfit Accessibility rules look something like this:

	An outfit accessibility rule for the nice suit:
		if the worn layers of the nice suit are 2:
			rule fails;
		else if the worn layers of the nice suit are 1:
			if the particular part are breasts:
				rule succeeds.

The plug-in is elegant enough to be fully compatible with characters that use the old layered clothing system instead of clothing sets, so it's perfectly fine to include this plug-in and just use Simpler AIF as normal.

*:
	A clothing set is a kind of thing. A clothing set is always wearable. The regular clothes are a clothing set. Understand "clothes/clothing/garments" as a clothing set.

	A clothing set has a number called the maximum worn layers. The maximum worn layers is usually 2. A clothing set has a number called the worn layers.
	A person has an object called the outfit. The outfit is usually nothing. A person has an object called the previously worn outfit. The previously worn outfit is usually nothing.

	Understand "take off [a clothing set]" as stripping. Understand "take [a clothing set] off" as stripping. Understand "remove [a clothing set]" as stripping. Understand "shed [a clothing set]" as stripping.

	To have (X - a person) change into (Y - a clothing set):
		unless the outfit of X is nothing:
			now the previously worn outfit of X is the outfit of X;
		now the outfit of X are Y;
		now the maximum worn layers of X are the maximum worn layers of Y;
		now the worn layers of X are the maximum worn layers of X;
		now the worn layers of Y are the maximum worn layers of Y.

	The stripping action has an object called the outfit taken off.

	Carry out an actor stripping a person when the noun wears a clothing set (called K) (this is the take off clothing sets when they aren't worn rule):
		decrement the worn layers of K;
		if the worn layers of K are 0:
			now the previously worn outfit is the outfit of the noun;
			now the outfit taken off is the outfit of the noun;
			if the noun is the player:
				now the noun is carrying K;
			else:
				now K is in the location of the noun;
			now the outfit of the noun is nothing;
			now the maximum worn layers of the noun is 0.

	Before an actor dressing when the maximum worn layers of the actor are 0 (this is the attempt find an outfit to dress into rule):
		let the potential outfit be an object;
		if the previously worn outfit of the actor is carried by the actor:
			now the potential outfit is the previously worn outfit of the actor;
		else if ((the previously worn outfit) of (the actor) is visible) and (the previously worn outfit of the actor is carried by nothing):
			now the potential outfit is the previously worn outfit of the actor;
		else if actor carries a clothing set (called K):
			now the potential outfit is K;
		if the potential outfit is nothing:
			say "There's nothing obvious for [the actor] to change into.";
			stop the action;
		else:
			try the actor wearing the potential outfit;
			stop the action.

	The wearing action has a object called the outfit replaced.

	First carry out an actor wearing a clothing set (this is the dispose of the previous outfit rule):
		unless the outfit of the actor is nothing:
			now the outfit replaced is the outfit of the actor;
			if the actor is not the player:
				now the outfit of the actor is in the location of the actor;
			else if the actor is the player:
				say "(first taking off [the outfit of the actor])";
				now the outfit of the actor is carried by the player;
		else:
			now the outfit replaced is nothing.
	Carry out an actor wearing a clothing set (this is the have the actor change into a new clothing set rule):
		have the actor change into the noun.

	Report an actor wearing a clothing set (this is the report an actor changing into a new clothing set rule):
		say "[The actor] [put] on [the noun].";
		rule succeeds.

	The populate maximum worn layers rule is not listed in the when play begins rulebook.
	When play begins (this is the populate maximum worn layers rule including outfits rule):
		repeat with X running through people:
			if X is wearing a clothing set (called K):
				now the outfit of X is K;
				now the maximum worn layers of the X is the maximum worn layers of K;
				now the worn layers of the X is the maximum worn layers of the X;
				now the worn layers of K is the maximum worn layers of K;
			else:
				now the worn layers of X is the maximum worn layers of X.

	The outfit accessibility rules are a clothing set based rulebook.

	First clothing accessibility rule for a person (called K) (this is the redirect to other clothing rule):
		unless the outfit of K is nothing or the worn layers of K is 0:
			abide by the outfit accessibility rules for the outfit of K.

Example: * Default Library Message Index - Not a game, but an index of all the default library messages used in Simpler AIF.

Since version 13, library messages are somewhat.... distributed... among a variety of rulebooks and systems. The first place to go customize messages is to copy out the tables below and replace them with ones of your own choosing.

*:
	Table of Failure Responses (amended)
	rule name	message
	the can't kiss anything but people rule	"[The person asked] [can't kiss] [the noun]."
	the can't kiss one's self rule	"[The person asked] [can't kiss] [themselves]."
	the can't lick one's own pussy rule	"[The person asked] [can't lick] [their] own pussy."
	the can't lick one's own ass rule	"[The person asked] [can't lick] [their] own ass."
	the can't lick one's own cock rule	"[The person asked] [can't lick] [their] own cock."
	the can't lick one's own face rule	"[The person asked] [can't lick] [their] own face."
	the can't lick one's own legs rule	"[The person asked] [can't lick] [their] own legs."
	the can't lick one's own tummy rule 	"[The person asked] [can't lick] [their] own tummy."
	the can't lick one's own chest rule	"[The person asked] [can't lick] [their] own chest."
	the can't lick just anything rule	"[The person asked] [shouldn't lick] [the noun]."
	the prevent a person with a cock from wearing a strap-on rule	"[The person asked] [can't wear] [a noun] over [their] cock."
	the can't wear two strap-ons rule	"[The person asked] [can wear] only one strap-on at a time."
	the block attempts to fuck rule	"[The person asked] [shouldn't fuck] [the noun]."
	the can't fuck something with itself rule	"[The person asked] [can't fuck] [the noun] with [themselves]."
	the can't fuck yourself with a part of yourself rule	"[The person asked] [can't fuck] [themselves]."
	the can't fuck with someone else's body part rule	"[The person asked] just [can't use] [the second noun] to fuck [regarding the person asked][themselves]."
	the can't fuck with a sex toy you don't have rule	"[The person asked] [can't fuck] with [the second noun] without first holding [them] first."
	the need to wear strap-ons before fucking with them rule	"[The person asked] [can't fuck] [themselves]."
	the can't fuck yourself with a strap-on rule	"[The noun] [are] not something that can be fucked."
	the can't fuck with something not fuckable rule	"[The second noun] [are] not something that can be fucked with."
	the can't fuck a sex toy with a sex toy rule	"Fucking [the noun] with [the second noun] is a bit redundant, isn't it?"

The ones below are relevant if you do not have the Advanced Layered Clothing extension installed.

*:
	Table of Failure Responses (amended)
	rule name	message
	the can't strip objects rule	"[The noun] [are] not something that can be stripped."
	the can't strip if already naked rule	"[The person asked] [are] already naked."
	the can't dress if already dressed rule	"[The person asked] [are] already dressed."
	the can't dress wearing a strap-on rule	"[The person asked] [can't] [dress] while wearing a strap-on."
	the must be naked to wear a strap-on rule	"[The person asked] must be naked before wearing [the noun]."

Various other messages exist elsewhere. Most notably, when an action attempts to redirect to fucking something else, but it can't find a viable body part, an error message is thrown up. Usually, this would be caused by a character with an incomplete set of sex organs... which shouldn't happen, but they are possible to trigger. Here they are.

	redirect attempts to fuck a male person rule response (A) is "New text.".
	redirect attempts to fuck a male person rule response (B) is "New text.".
	redirect titfucking rule response (A) is "New text.".
	redirect titfucking rule response (B) is "New text.".
	redirect assfucking rule response (A) is "New text.".
	redirect assfucking rule response (B) is "New text.".
	can't masturbate without genitals rule response (A) is "New text.".
	redirect fucking a person with something penile to fucking a body part rule response (A) is "New text.".
	redirect fucking a person with something orificial to fucking a body part rule response (A) is "New text.".
	redirect attempts to fuck something with a person to fucking with a body part rule response (A) is "New text.".
	redirect attempts to fuck a person with something to fucking a body part rule response (A) is "New text.".

As you can see, they are all redirect, displaying some variation of "Holy shit they don't have an X".

All the other messages are controlled through dedicated rulebooks (sexual orientation rules, obstructed sex act rules) which are covered in their respective chapters, or they are handled by text variables (generic sex refusal message, wrong sexuality message).

Example: * Default Interactions Reference - An index of possible interactions between two default characters. 

Here is a list of interactions possible by default in Simpler AIF. Use this as a checklist to write your AIF scene. If you cover each of these possibilities, then you will have written a relatively fleshed out AIF scene. Please note that this list includes the optional body parts. If you aren't planning on including them, simply omit them. (ones that don't require optional body parts are marked by an asterix).

Instructions: For each person in the scene, copy the appropriate solo interactions. Then, for each pair in the scene, copy the interactions for both the man and a woman.

For example, if we have a threesome scene between Jenny, Hannah and Curtis (3,000 points if you can tell me where those three names came from), we'll need lists for:

	Jenny's solo female interactions
	Hannah's solo female interactions
	Curtis's solo female interactions
	Jenny actor, Hannah partner interactions
	Hannah actor, Jenny partner interactions
	Curtis actor, Hannah partner interactions
	Hannah actor, Curtis partner interactions
	Curtis actor, Jenny partner interactions
	Jenny actor, Curtis partner interactions

For a total of 9 lists of interactions. You can see how the work tends to multiply for each additional person. If we had chosen a scene with just two people, we would have only required 4 lists. If we add Todd to the mix (and assume he'll be willing to play with Curtis as well) we would be using 16 (!) lists. Beyond that the amount of work gets wildly out of control, with 5 individuals requiring 25 lists, 6 individuals, 36, 7 individuals 49 and so on. At that level you might seriously consider investing time in writing a dynamic AIF prose system.

Solo female interactions --

	Stripping self*
	Rubbing own breasts*
	Rubbing own ass*
	Rubbing own pussy*
	Rubbing own face
	Rubbing own tummy
	Rubbing own legs
	Licking own breasts*

Solo male interactions --

	Stripping self*
	Rubbing own ass*
	Rubbing own cock*
	Rubbing own face
	Rubbing own legs
	Rubbing own tummy
	Rubbing own chest

Male actor, female partner interactions --

	Stripping woman*
	Kissing woman*
	Rubbing breasts*
	Rubbing ass*
	Rubbing pussy*
	Rubbing face
	Rubbing legs
	Rubbing tummy
	Licking breasts*
	Licking ass*
	Licking pussy*
	Licking legs
	Licking tummy
	Fucking face with cock
	Fucking breasts with cock*
	Fucking ass with cock*
	Fucking pussy with cock*

Female actor, male partner interactions --

	Stripping man*
	Kissing man*
	Rubbing ass*
	Rubbing cock*
	Rubbing face
	Rubbing legs
	Rubbing tummy
	Rubbing chest
	Licking ass*
	Licking cock*
	Licking legs
	Licking tummy
	Licking chest
	Fucking cock with pussy*
	Fucking cock with breasts*
	Fucking cock with ass*
	Fucking face with pussy

Female actor, female partner interactions --

	Stripping woman*
	Kissing woman*
	Rubbing breasts*
	Rubbing ass*
	Rubbing pussy*
	Rubbing face
	Rubbing legs
	Rubbing tummy
	Licking breasts*
	Licking ass*
	Licking pussy*
	Licking legs
	Licking tummy
	Fucking face with pussy
	Fucking pussy with pussy*

Male actor, male partner interactions --

	Stripping man*
	Kissing man*
	Rubbing ass*
	Rubbing cock*
	Rubbing face
	Rubbing legs
	Rubbing tummy
	Rubbing chest
	Licking ass*
	Licking cock*
	Licking legs
	Licking tummy
	Licking chest
	Fucking ass with cock*
	Fucking face with cock
	Fucking cock with ass*
	Fucking cock with cock*

Example: ** Dressing Room Antics - A scenario used to test the features of the Clothing Sets Plug-in

Before you use plop this example into the game, be warned that the Clothing Sets Plug-in is ABSOLUTELY REQUIRED and will not compile unless you drop it in. This is basically a small game used to playtest clothing sets.

*:	
	Include Simpler AIF by Another Wannabe.
	
	The dressing room is a room.

	The mascot costume is a clothing set in the dressing room. The maximum worn layers is 1. The description is "This is a costume of a bear with a hole to let a cock through." Understand "bear suit" and "bear" as the mascot costume.

	An outfit accessibility rule for the mascot costume:
		unless the particular part is a cock:
			rule fails;
		rule succeeds.

	After wearing the mascot costume:
		say "Anna giggles at you as you slip on the mascot outfit. Your naked cock pokes out from the hole in the front."
	After Anna wearing the mascot costume:
		say "Anna blushes a bit as she slips on the mascot outfit."

	The tennis uniform is a clothing set in the dressing room. The maximum worn layers is 1. The description is "This pink tennis outfit has a white skirt. No underwear included."

	An outfit accessibility rule for the tennis uniform:
		if the particular part is an ass or particular part is a pussy or particular part is an cock:
			rule succeeds;
		rule fails.

	After wearing the tennis uniform:
		say "Anna laughs hysterically as you put the uniform on."
	After Anna wearing the tennis uniform:
		say "Anna cheekily slips on the uniform, flashing you her bare womanhood as she does so."

	The casual clothes are a clothing set. The maximum worn layers are 2. Understand "shirt/jeans" as the casual clothes. The description is "It's just a simple set of shirt and jeans."

	An outfit accessibility rule for the casual clothes:
		rule fails.

	After Anna stripping when the worn layers of Anna are 1 and the outfit of Anna is the casual clothes:
		say "Anna strips off her shirt and jean, revealing a bra and panties."
		
	After wearing the casual clothes:
		say "The clothes are a bit tight for you, but Anna finds that amusing."
	After Anna wearing the casual clothes:
		say "Anna slips into her old clothes, looking a bit sad the fun might be over."

	The nice suit is a clothing set. The player is wearing the nice suit. The maximum worn layers are 2. The description is "A recently pressed suit, you just got it from the dry cleaners."


	An outfit accessibility rule for the nice suit:
		if the worn layers of the nice suit are 2:
			rule fails;
		else if the worn layers of the nice suit are 1:
			if the particular part are breasts:
				rule succeeds.

	After Anna stripping when the worn layers of Anna are 1 and the outfit of Anna is the nice suit:
		say "Anna pulls off [italic type]your[roman type] business suit from her busty body, and of course you don't have a bra..."
		
	After wearing the nice suit:
		say "Anna nods lustily. She thinks you look sexy in the suit."
	After Anna wearing the nice suit:
		say "Anna laughs as she pulls on your clothes. They're way too big for her."

	Persuasion rule for asking Anna to try taking a clothing set:
		persuasion succeeds.
	Persuasion rule for asking Anna to try wearing:
		persuasion succeeds.

	The player is male.

	Anna is a woman in the dressing room. She is sex ready. Anna wears the casual clothes.

	Instead of examining Anna:
		say "You've finally managed to sneak the busty, lusty Anna away to a private location. ";
		if the worn layers of Anna are 0:
			say "Anna is buck naked.";
		if the outfit of Anna is the casual clothes:
			if the worn layers of Anna are 1:
				say "She is down to her bra and panties.";
			else:
				say "Anna is in her t-shirt and jeans.";
		else if the outfit of Anna is the nice suit:
			if the worn layers of Anna are 1:
				say "Anna is braless, barely able to keep your boxers on.";
			else:
				say "Anna wears your suit that you brought for the meeting. The sleeves go over her hands comically.";
		else if the outfit of Anna is the mascot costume:
			say "Anna wears the bear costume. The front flap is hanging empty, presumably where a cock would stick out.";
		else if the outfit of Anna is the tennis uniform:
			say "Anna wears a very cute tennis uniform. She likes to flash her bare buttocks and pussy at you."

